Category:2009_flu_pandemic_by_country	Category:Health	2009_flu_pandemic_by_country
Category:Aboriginal_title	Category:Common_law Category:Law	Aboriginal_title
Category:Abortion_by_country	Category:Society	Abortion_law
Category:Abortion_debate	Category:Politics	Abortion_debate
Category:Abuse_of_the_legal_system	Category:Law Category:Practice_of_law Category:Sociology_of_law	Legal_abuse
Category:Academic_administration	Category:Education	Academic_administration
Category:Academic_administrators	Category:Education	Academic_administration
Category:Academic_degrees	Category:Education	Academic_degree
Category:Academic_disciplines	Category:Education	List_of_academic_disciplines
Category:Academic_dress	Category:Education	Academic_dress
Category:Academic_libraries	Category:Education	Academic_library
Category:Academic_publishing	Category:Education	Academic_publishing
Category:Accessibility	Category:Disability	Accessibility
Category:Accidents	Category:History	Accident
Category:Accountancy	Category:Business Category:Finance	Accountancy
Category:Accountants	Category:Accountancy	Accountant
Category:Accounting_scholarship	Category:Accountancy	Accounting_scholarship
Category:Accounting_software	Category:Accountancy	Accounting_software
Category:Accounting_systems	Category:Accountancy	Accounting_software
Category:Ace_Attorney	Category:Law	Ace_Attorney
Category:Acting	Category:Drama Category:Performing_arts	Acting
Category:Action_T4	Category:Disability	Action_T4
Category:Activism	Category:Social_change Category:Society	Activism
Category:Activists	Category:Politics	Activism
Category:Actor-network_theory	Category:Science_and_technology_studies	Actor-network_theory
Category:Actuarial_science	Category:Business	Actuarial_science
Category:Administrative_law	Category:Law	Administrative_law
Category:Adoption	Category:Family	Adoption
Category:Adult_education	Category:Education	Adult_education
Category:Advanced_Placement	Category:Educational_programs	Advanced_Placement
Category:Adventure	Category:Entertainment	Adventure
Category:Advertisements	Category:Business Category:Creative_works	Advertising
Category:Advertising	Category:Business	Advertising
Category:Advocacy_groups	Category:Political_activism Category:Political_organizations	Advocacy_group
Category:Aesthetics	Category:Arts	Aesthetics
Category:African_American_studies	Category:Ethnic_studies	African_American_studies
Category:African_studies	Category:Area_studies	African_studies
Category:Agency_law	Category:Business_law Category:Law	Law_of_agency
Category:Aging-associated_diseases	Category:Health	Aging-associated_diseases
Category:Agrarianism	Category:Agriculture	Agrarianism
Category:Agricultural_chemicals	Category:Agriculture Category:Industrial_agriculture	Agrochemical
Category:Agricultural_cooperatives	Category:Agrarianism Category:Agriculture	Agricultural_cooperative
Category:Agricultural_economics	Category:Agriculture Category:Economics	Agricultural_economics
Category:Agricultural_education	Category:Agriculture Category:Education Category:Vocational_education	Agricultural_education
Category:Agricultural_engineers	Category:Agriculture Category:Industrial_agriculture	Agricultural_engineering
Category:Agriculturalists	Category:Agriculture	Farmer
Category:Agricultural_land	Category:Agriculture	Agricultural_land
Category:Agricultural_law	Category:Agriculture Category:Law	Agricultural_law
Category:Agricultural_production	Category:Agriculture	Primary_sector_of_the_economy
Category:Agricultural_shows	Category:Agriculture	Agricultural_show
Category:Agricultural_universities_and_colleges	Category:Agriculture	List_of_agricultural_universities_and_colleges
Category:Agriculture	\N	Agriculture
Category:Agriculture_in_Algeria	Category:Agriculture	Agriculture_in_Algeria
Category:Agriculture_in_Angola	Category:Agriculture	Agriculture_in_Angola
Category:Agriculture_in_Argentina	Category:Agriculture	Agriculture_in_Argentina
Category:Agriculture_in_Armenia	Category:Agriculture	Agriculture_in_Armenia
Category:Agriculture_in_Australia	Category:Agriculture	Agriculture_in_Australia
Category:Agriculture_in_Austria	Category:Agriculture	Agriculture_in_Austria
Category:Agriculture_in_Azerbaijan	Category:Agriculture	Agriculture_in_Azerbaijan
Category:Agriculture_in_Bahrain	Category:Agriculture	Agriculture_in_Bahrain
Category:Agriculture_in_Bangladesh	Category:Agriculture	Agriculture_in_Bangladesh
Category:Agriculture_in_Belarus	Category:Agriculture	Agriculture_in_Belarus
Category:Agriculture_in_Bhutan	Category:Agriculture	Agriculture_in_Bhutan
Category:Agriculture_in_Bolivia	Category:Agriculture	Agriculture_in_Bolivia
Category:Agriculture_in_Brazil	Category:Agriculture	Agriculture_in_Brazil
Category:Agriculture_in_Bulgaria	Category:Agriculture	Agriculture_in_Bulgaria
Category:Agriculture_in_Burkina_Faso	Category:Agriculture	Agriculture_in_Burkina_Faso
Category:Agriculture_in_Burma	Category:Agriculture	Agriculture_in_Burma
Category:Agriculture_in_Burundi	Category:Agriculture	Agriculture_in_Burundi
Category:Agriculture_in_Cambodia	Category:Agriculture	Agriculture_in_Cambodia
Category:Agriculture_in_Canada	Category:Agriculture	Agriculture_in_Canada
Category:Agriculture_in_Chad	Category:Agriculture	Agriculture_in_Chad
Category:Agriculture_in_Chile	Category:Agriculture	Agriculture_in_Chile
Category:Agriculture_in_Colombia	Category:Agriculture	Agriculture_in_Colombia
Category:Agriculture_in_Cuba	Category:Agriculture	Agriculture_in_Cuba
Category:Agriculture_in_Equatorial_Guinea	Category:Agriculture	Agriculture_in_Equatorial_Guinea
Category:Agriculture_in_Eritrea	Category:Agriculture	Agriculture_in_Eritrea
Category:Agriculture_in_Estonia	Category:Agriculture	Agriculture_in_Estonia
Category:Agriculture_in_Ethiopia	Category:Agriculture	Agriculture_in_Ethiopia
Category:Agriculture_in_Gabon	Category:Agriculture	Agriculture_in_Gabon
Category:Agriculture_in_Georgia_%28country%29	Category:Agriculture	Agriculture_in_Georgia_%28country%29
Category:Agriculture_in_Ghana	Category:Agriculture	Agriculture_in_Ghana
Category:Agriculture_in_Guinea	Category:Agriculture	Agriculture_in_Guinea
Category:Agriculture_in_Guyana	Category:Agriculture	Agriculture_in_Guyana
Category:Agriculture_in_Haiti	Category:Agriculture	Agriculture_in_Haiti
Category:Agriculture_in_Iceland	Category:Agriculture	Agriculture_in_Iceland
Category:Agriculture_in_India	Category:Agriculture	Agriculture_in_India
Category:Agriculture_in_Iran	Category:Agriculture	Agriculture_in_Iran
Category:Agriculture_in_Israel	Category:Agriculture	Agriculture_in_Israel
Category:Agriculture_in_Japan	Category:Agriculture	Agriculture,_forestry,_and_fishing_in_Japan
Category:Agriculture_in_Kazakhstan	Category:Agriculture	Agriculture_in_Kazakhstan
Category:Agriculture_in_Kenya	Category:Agriculture	Agriculture_in_Kenya
Category:Agriculture_in_Kyrgyzstan	Category:Agriculture	Agriculture_in_Kyrgyzstan
Category:Agriculture_in_Laos	Category:Agriculture	Agriculture_in_Laos
Category:Agriculture_in_Latvia	Category:Agriculture	Agriculture_in_Latvia
Category:Agriculture_in_Lebanon	Category:Agriculture	Agriculture_in_Lebanon
Category:Agriculture_in_Libya	Category:Agriculture	Agriculture_in_Libya
Category:Agriculture_in_Malaysia	Category:Agriculture	Agriculture_in_Malaysia
Category:Agriculture_in_Mauritania	Category:Agriculture	Agriculture_in_Mauritania
Category:Agriculture_in_Mesoamerica	Category:Agriculture	Agriculture_in_Mesoamerica
Category:Agriculture_in_Mongolia	Category:Agriculture	Agriculture_in_Mongolia
Category:Agriculture_in_Mozambique	Category:Agriculture	Agriculture_in_Mozambique
Category:Agriculture_in_Namibia	Category:Agriculture	Agriculture_in_Namibia
Category:Agriculture_in_Nepal	Category:Agriculture	Agriculture_in_Nepal
Category:Agriculture_in_New_Zealand	Category:Agriculture	Agriculture_in_New_Zealand
Category:Agriculture_in_Nicaragua	Category:Agriculture	Agriculture_in_Nicaragua
Category:Agriculture_in_Niger	Category:Agriculture	Agriculture_in_Niger
Category:Agriculture_in_Nigeria	Category:Agriculture	Agriculture_in_Nigeria
Category:Agriculture_in_Oman	Category:Agriculture	Agriculture_in_Oman
Category:Agriculture_in_Pakistan	Category:Agriculture	Agriculture_in_Pakistan
Category:Agriculture_in_Panama	Category:Agriculture	Agriculture_in_Panama
Category:Agriculture_in_Paraguay	Category:Agriculture	Agriculture_in_Paraguay
Category:Agriculture_in_Peru	Category:Agriculture	Agricultural_history_of_Peru
Category:Agriculture_in_Poland	Category:Agriculture	Agriculture_in_Poland
Category:Agriculture_in_Portugal	Category:Agriculture	Agriculture_in_Portugal
Category:Agriculture_in_Qatar	Category:Agriculture	Agriculture_in_Qatar
Category:Agriculture_in_Romania	Category:Agriculture	Agriculture_in_Romania
Category:Agriculture_in_Russia	Category:Agriculture	Agriculture_in_Russia
Category:Agriculture_in_Saudi_Arabia	Category:Agriculture	Agriculture_in_Saudi_Arabia
Category:Agriculture_in_Scotland	Category:Agriculture	Agriculture_in_Scotland
Category:Agriculture_in_Senegal	Category:Agriculture	Agriculture_in_Senegal
Category:Agriculture_in_Sierra_Leone	Category:Agriculture	Agriculture_in_Sierra_Leone
Category:Agriculture_in_South_Africa	Category:Agriculture	Agriculture_in_South_Africa
Category:Agriculture_in_Spain	Category:Agriculture	Agriculture_in_Spain
Category:Agriculture_in_Sri_Lanka	Category:Agriculture	Agriculture_in_Sri_Lanka
Category:Agriculture_in_Sudan	Category:Agriculture	Agriculture_in_Sudan
Category:Agriculture_in_Suriname	Category:Agriculture	Agriculture_in_Suriname
Category:Agriculture_in_Sweden	Category:Agriculture	Agriculture_in_Sweden
Category:Agriculture_in_Syria	Category:Agriculture	Agriculture_in_Syria
Category:Agriculture_in_Tajikistan	Category:Agriculture	Agriculture_in_Tajikistan
Category:Agriculture_in_Thailand	Category:Agriculture	Agriculture_in_Thailand
Category:Agriculture_in_the_Bahamas	Category:Agriculture	Agriculture_in_the_Bahamas
Category:Agriculture_in_the_Soviet_Union	Category:Agriculture	Agriculture_in_the_Soviet_Union
Category:Agriculture_in_the_United_Arab_Emirates	Category:Agriculture	Agriculture_in_the_United_Arab_Emirates
Category:Agriculture_in_the_United_Kingdom	Category:Agriculture	Agriculture_in_the_United_Kingdom
Category:Agriculture_in_Turkmenistan	Category:Agriculture	Agriculture_in_Turkmenistan
Category:Agriculture_in_Uganda	Category:Agriculture	Agriculture_in_Uganda
Category:Agriculture_in_Uzbekistan	Category:Agriculture	Agriculture_in_Uzbekistan
Category:Agriculture_in_Venezuela	Category:Agriculture	Agriculture_in_Venezuela
Category:Agriculture_in_Vietnam	Category:Agriculture	Agriculture_in_Vietnam
Category:Agronomy	Category:Agriculture	Agronomy
Category:Aircraft_instruments	Category:Technology_systems	Flight_instruments
Category:Allegory	Category:Arts	Allegory
Category:Alternate_history	Category:History	Alternate_history
Category:Alternative_education	Category:Education	Alternative_education
Category:Alternative_energy	Category:Energy	Alternative_energy
Category:Alternative_medicine	Category:Health Category:Medicine	Alternative_medicine
Category:Alternative_schools	Category:Alternative_education	Alternative_school
Category:Alumni_associations	Category:Education	Alumni_association
Category:American_society	Category:Society	Culture_of_the_United_States
Category:American_studies	Category:Area_studies	American_studies
Category:Amplifiers	Category:Technology_systems	Amplifier
Category:Amusement_parks	Category:Entertainment	Amusement_park
Category:Analytics	Category:Business_intelligence	Analytics
Category:Anarchism	Category:Culture Category:Political_philosophy Category:Politics	Anarchism
Category:Ancient_Egyptian_technology	Category:History_of_technology	Ancient_Egyptian_technology
Category:Ancient_Greek_law	Category:Legal_history	Ancient_Greek_law
Category:Ancient_Greek_technology	Category:History_of_technology	Ancient_Greek_technology
Category:Ancient_Greek_theatre	Category:Arts	Theatre_of_ancient_Greece
Category:Ancient_history	Category:History	Ancient_history
Category:Ancient_languages	Category:Languages	Historical_linguistics
Category:Ancient_Roman_technology	Category:History_of_technology	Roman_technology
Category:Ancient_universities	Category:History_of_education	Ancient_university
Category:Andrew_Carnegie	Category:Business	Andrew_Carnegie
Category:Aniconism	Category:Aesthetics	Aniconism
Category:Animal_anatomy	Category:Veterinary_medicine	Anatomy
Category:Animal_communication	Category:Communication	Animal_communication
Category:Animal_law	Category:Law	Animal_law
Category:Animal_products	Category:Food_and_drink Category:Natural_materials	Animal_product
Category:Animal_rights	Category:Rights	Animal_rights
Category:Animal_shelters	Category:Culture	Animal_shelter
Category:Animal_training	Category:Culture	Animal_training
Category:Animal_virology	Category:Veterinary_medicine	Animal_virology
Category:Anniversaries	Category:Chronology Category:History	Anniversary
Category:Antennas	Category:Wireless	Antenna_%28radio%29
Category:Anthropology	Category:Interdisciplinary_fields Category:Museology Category:Social_sciences	Anthropology
Category:Anti-globalization	Category:Globalization	Anti-globalization_movement
Category:Anti-gravity	Category:Fictional_technology	Anti-gravity
Category:Anti-intellectualism	Category:Education	Anti-intellectualism
Category:Antimatter	Category:Matter	Antimatter
Category:Antipredator_adaptations	Category:Evolution	Antipredator_adaptation
Category:Anti-psychiatry	Category:Philosophy_of_science	Anti-psychiatry
Category:Antiques	Category:History	Antique
Category:Anti-social_behaviour	Category:Society	Anti-social_behaviour
Category:Applied_linguistics	Category:Linguistics	Applied_linguistics
Category:Applied_sciences	Category:Science	Applied_science
Category:Appropriate_technology	Category:Technology	Appropriate_technology
Category:April_Fools%27_Day	Category:Comedy	April_Fools%27_Day
Category:Aquaculture	Category:Agriculture	Aquaculture
Category:Aquanauts	Category:Exploration	Aquanaut
Category:Arbitration	Category:Business_law Category:Law	Arbitration
Category:Archaeological_sites	Category:Archaeology	Archaeological_site
Category:Archaeological_sub-disciplines	Category:Archaeology	Archaeological_sub-disciplines
Category:Archaeological_theory	Category:Archaeology	Archaeological_theory
Category:Archaeologists	Category:Archaeology	Archaeology
Category:Archaeology	Category:History Category:Museology	Archaeology
Category:Archaeology_museums	Category:Archaeology Category:History Category:Society	Museum
Category:Architects	Category:Arts	Architect
Category:Architectural_competitions	Category:Arts	Architectural_design_competition
Category:Architectural_theory	Category:Interdisciplinary_fields	Architectural_theory
Category:Architecture	Category:Visual_arts	Architecture
Category:Archival_science	Category:Museology	Archival_science
Category:Archives	Category:Culture Category:Education Category:History	Archive
Category:Area_studies	Category:Cultural_anthropology Category:Humanities Category:Interdisciplinary_fields Category:Social_sciences	Area_studies
Category:Armenian_history	Category:History	History_of_Armenia
Category:Art_competitions_at_the_Olympic_Games	Category:Arts	Art_competitions_at_the_Olympic_Games
Category:Art_education	Category:Culture Category:Education Category:Visual_arts	Art_education
Category:Art_exhibitions	Category:Arts Category:Visual_arts	Art_exhibition
Category:Art_festivals	Category:Performing_arts	Arts_festival
Category:Art_history	Category:Cultural_history Category:History Category:Museology Category:Visual_arts	Art_history
Category:Artificial_intelligence	Category:Interdisciplinary_fields	Artificial_intelligence
Category:Artificial_intelligence_applications	Category:Science	Applications_of_artificial_intelligence
Category:Artificial_life	Category:Computational_science	Artificial_life
Category:Artisans	Category:Arts	Artisan
Category:Artistic_directors	Category:Arts	Artistic_director
Category:Artists	Category:Visual_arts	Artist
Category:Arts	Category:Culture Category:Humanities	The_arts
Category:Arts_and_crafts	Category:Arts	Arts_and_crafts
Category:Arts_and_Crafts_Movement	Category:Arts	Arts_and_Crafts_Movement
Category:Arts_centres	Category:Arts	Arts_centre
Category:Art_schools	Category:Visual_arts	Art_school
Category:Arts_festivals	Category:Arts	Arts_festival
Category:Asian_studies	Category:Area_studies	Asian_studies
Category:Assassination_of_John_F._Kennedy	Category:History	Assassination_of_John_F._Kennedy
Category:Assistive_technology	Category:Technology	Assistive_technology
Category:Association_of_Independent_Technological_Universities	Category:Technology	Association_of_Independent_Technological_Universities
Category:Assyriology	Category:Area_studies	Assyriology
Category:Astronomers	Category:Scientists	Astronomer
Category:Astronomical_objects	Category:Geography Category:Universe	Astronomical_object
Category:Astronomical_observatories_by_country	Category:Technology	Observatory
Category:Atmosphere	Category:Earth	Atmosphere
Category:Atmospheric_scientists	Category:Scientists	Atmospheric_sciences
Category:Atoms	Category:Matter	Atom
Category:Attention	Category:Learning	Attention
Category:Auctioneering	Category:Business_models	Auction
Category:Audiologists	Category:Health	Audiology
Category:Audiology	Category:Health_sciences	Audiology
Category:Augmentative_and_alternative_communication	Category:Communication	Augmentative_and_alternative_communication
Category:Autism	Category:Disability	Autism
Category:Automation	Category:Technology	Automation
Category:Auxiliary_sciences_of_history	Category:History	Auxiliary_sciences_of_history
Category:Avalanches	Category:Natural_hazards	Avalanche
Category:Aviation_history	Category:History Category:History_of_technology	Aviation_history
Category:Aztec_history	Category:History	History_of_the_Aztecs
Category:Badges	Category:Clothing	Badge
Category:Ballet_terminology	Category:Terminology	Glossary_of_ballet
Category:Bamboo	Category:Natural_materials	Bamboo
Category:Bangladeshi_society	Category:Society	Bangladeshi_society
Category:Bank_failures	Category:Business	Bank_failure
Category:Banking	Category:Finance	Bank
Category:Bankruptcy	Category:Business_law	Bankruptcy
Category:Baryons	Category:Matter	Baryon
Category:Basic_income	Category:Socioeconomics	Basic_income_guarantee
Category:Basket_weaving	Category:Arts	Basket_weaving
Category:Bathing	Category:Hygiene	Bathing
Category:BattleTech_technology	Category:Fictional_technology	BattleTech_technology
Category:BBCH-scale	Category:Agronomy Category:Crops	BBCH-scale
Category:BDSM_organizations	Category:Society	List_of_BDSM_organizations
Category:Beadwork	Category:Arts	Beadwork
Category:Beauty	Category:Aesthetics	Beauty
Category:Bedding	Category:Home	Bedding
Category:Beekeeping	Category:Agriculture Category:Domesticated_animals	Beekeeping
Category:Behavioural_sciences	Category:Science	Behavioural_sciences
Category:Belizean_society	Category:Society	Belizean_society
Category:Berlin_Institute_of_Technology	Category:Technology	Berlin_Institute_of_Technology
Category:Bhakti_movement	Category:Arts	Bhakti_movement
Category:Biblical_studies	Category:Study_of_religion	Biblical_studies
Category:Bilingualism_in_Canada	Category:Language_policy	Official_bilingualism_in_Canada
Category:Billboards	Category:Business	Billboard
Category:Bill_Gates	Category:Business	Bill_Gates
Category:Bioengineering	Category:Health_sciences	Biological_engineering
Category:Biographical_films	Category:Biography Category:History	Biographical_film
Category:Biography	Category:History Category:People	Biography
Category:Bioinformatics	Category:Computational_science Category:Interdisciplinary_fields	Bioinformatics
Category:Biological_evolution	Category:Evolution	Evolution
Category:Biological_hazards	Category:Natural_hazards	Biological_hazard
Category:Biological_nomenclature	Category:Scientific_classification	Biological_classification
Category:Biological_pest_control	Category:Agriculture Category:Organic_farming	Biological_pest_control
Category:Biological_systems	Category:Systems	Systems_biology
Category:Biological_warfare	Category:Science Category:Society	Biological_warfare
Category:Biologists	Category:Scientists	Biologist
Category:Biology	Category:Natural_sciences	Biology
Category:Biomaterials	Category:Medical_technology	Biomaterial
Category:Biomedical_engineering	Category:Interdisciplinary_fields	Biomedical_engineering
Category:Biomedicine	Category:Medicine Category:Veterinary_medicine	Biomedicine
Category:Biopower	Category:Political_philosophy	Biopower
Category:Birla_family	Category:Business	Birla_family
Category:Blasphemy_law	Category:Law	Blasphemy_law
Category:Blindness	Category:Disability	Blindness
Category:Blood_diamonds	Category:Business_ethics	Blood_diamond
Category:Braunschweig_University_of_Technology	Category:Technology	Braunschweig_University_of_Technology
Category:Brazilian_society	Category:Society	Demographics_of_Brazil
Category:Breeds	Category:Domesticated_animals	Breed
Category:Broadcast_law	Category:Law	Broadcast_law
Category:Bronfman_family	Category:Business	Bronfman_family
Category:Buddhist_studies	Category:Study_of_religion	Buddhist_studies
Category:Building_automation	Category:Automation	Building_automation
Category:Building_materials	Category:Agriculture	Building_material
Category:Business	Category:Society	Business
Category:Business_analysis	Category:Business	Business_analysis
Category:Business_education	Category:Business Category:Education	Business_education
Category:Business_ethics	Category:Business	Business_ethics
Category:Business_incubators	Category:Business_organizations Category:Entrepreneurship	Business_incubator
Category:Business_intelligence	Category:Business Category:Information_technology	Business_intelligence
Category:Business_journalism	Category:Business	Business_journalism
Category:Business_law	Category:Business Category:Law	Commercial_law
Category:Business_models	Category:Business	Business_model
Category:Business_opportunities	Category:Business	Business_opportunity
Category:Business_organizations	Category:Business	Companies_law
Category:Businesspeople	Category:Business	Businessperson
Category:Business_schools	Category:Business_education	Business_school
Category:Business_simulation_games	Category:Business_software	Business_simulation_game
Category:Business_software	Category:Business	Business_software
Category:Buskers	Category:Performing_arts	Street_performance
Category:Busking	Category:Performing_arts	Street_performance
Category:By-elections	Category:Elections	By-election
Category:Byzantine_science	Category:History_of_science	Byzantine_science
Category:%C3%96zal_family	Category:Business	%C3%96zal_family
Category:Calendars	Category:Chronology	Calendar
Category:Calligraphy	Category:Arts Category:Writing	Calligraphy
Category:Call_signs	Category:Wireless	Call_sign
Category:Canary_Wharf	Category:Business	Canary_Wharf
Category:Case_law	Category:Law	Case_law
Category:Caste	Category:Law	Caste
Category:Castles	Category:History	Castle
Category:Casual_sex	Category:Society	Casual_sex
Category:Catheters	Category:Medical_technology	Catheter
Category:Cats	Category:Domesticated_animals	Cat
Category:Cattlemen	Category:Agriculture	Ranch
Category:Causality	Category:History Category:Inductive_reasoning Category:Philosophy_of_science	Causality
Category:Cave_surveying	Category:Surveying	Cave_survey
Category:Celtic_studies	Category:Area_studies	Celtic_studies
Category:Censorship_by_religion	Category:Society	Censorship_by_religion
Category:Centrale_Graduate_School	Category:Technology	Centrale_Graduate_School
Category:Central,_Hong_Kong	Category:Business	Central,_Hong_Kong
Category:Centuries	Category:Chronology	Century
Category:Chambers_of_commerce	Category:Business_organizations Category:Commerce	Chamber_of_commerce
Category:Change_management	Category:Business Category:Management	Change_management
Category:Chaos_theory	Category:Science	Chaos_theory
Category:Character_encoding	Category:Language	Character_encoding
Category:Cheerleading	Category:Entertainment	Cheerleading
Category:Chemical_education	Category:Education	Chemistry_education
Category:Chemical_elements	Category:Matter	Chemical_element
Category:Chemical_warfare	Category:Science Category:Society	Chemical_warfare
Category:Cheminformatics	Category:Computational_science Category:Interdisciplinary_fields	Cheminformatics
Category:Chemists	Category:Scientists	Chemist
Category:Child_labour	Category:Business_ethics Category:Social_history	Child_labour
Category:Children%27s_museums	Category:Education	Children%27s_museum
Category:Child_sexual_abuse	Category:Society	Child_sexual_abuse
Category:Child_welfare	Category:Social_work	Child_protection
Category:Chinese_law	Category:Legal_history	Chinese_law
Category:Chiropractic_schools	Category:Health_education	List_of_chiropractic_schools
Category:Choreographed_combat	Category:Performing_arts	Stage_combat
Category:Christmas_tree_farming	Category:Agriculture Category:Crops	Christmas_tree_cultivation
Category:Chronology	Category:Humanities	Chronology
Category:Circuses	Category:Performing_arts	Circus
Category:Cisco_Systems_acquisitions	Category:Mergers_and_acquisitions	List_of_acquisitions_by_Cisco_Systems
Category:Citizen_science	Category:Science Category:Society	Citizen_science
Category:Cityscapes	Category:Landscape	Cityscape
Category:Civics	Category:Education Category:Government Category:Life_skills Category:Politics	Civics
Category:Civil_codes	Category:Civil_law_%28legal_system%29	Civil_code
Category:Civil%E2%80%93military_relations	Category:Politics	Civil%E2%80%93military_relations
Category:Civilizations	Category:Archaeology Category:Cultural_history Category:Culture Category:History	Civilization
Category:Civil_law_%28common_law%29	Category:Law	Civil_law_%28common_law%29
Category:Civil_law_%28legal_system%29	Category:Law	Civil_law_%28legal_system%29
Category:Civil_law_legal_systems	Category:Civil_law_%28legal_system%29	Civil_law_%28legal_system%29
Category:Civil_rights_and_liberties	Category:Political_philosophy Category:Rights	Civil_and_political_rights
Category:Civil_services	Category:Government	Civil_service
Category:Civil_society	Category:Politics Category:Society	Civil_society
Category:Clans	Category:Corporate_groups Category:Family	Clan
Category:Classical_philology	Category:Philology	Classical_philology
Category:Classical_studies	Category:History	Classics
Category:Cleaning	Category:Home Category:Hygiene	Cleanliness
Category:Clerks	Category:Business	Clerks
Category:Clinical_pharmacology	Category:Health_policy	Clinical_pharmacology
Category:Clothing	Category:Culture	Clothing
Category:Coalition_governments	Category:Elections Category:Government	Coalition_government
Category:Cognitive_science	Category:Interdisciplinary_fields Category:Linguistics Category:Science	Cognitive_science
Category:Collaboration	Category:Communication	Collaboration
Category:Collaborative_software	Category:Business_software	Collaborative_software
Category:Collecting	Category:Procurement	Collecting
Category:Collective_rights	Category:Rights	Individual_and_group_rights
Category:Colonialism	Category:History	Colonialism
Category:Comedy	Category:Entertainment Category:Humanities Category:Performing_arts	Comedy
Category:Comedy_genres	Category:Comedy	Comedic_genres
Category:Comic_science_fiction	Category:Comedy	Comic_science_fiction
Category:Comics_portal	Category:Arts	Portal:Comics
Category:Comics_terminology	Category:Terminology	Comics_vocabulary
Category:Commedia_dell%27arte	Category:Comedy	Commedia_dell%27arte
Category:Commemorative_coins	Category:History	Commemorative_coin
Category:Commerce	Category:Business	Commerce
Category:Commercial_failures	Category:Business	Failure
Category:Commercial_spaceflight	Category:Commerce	Private_spaceflight
Category:Committees	Category:Corporate_groups	Committee
Category:Commodity_exchanges	Category:Commerce	Commodities_exchange
Category:Common_law	Category:Law	Common_law
Category:Common_law_legal_systems	Category:Common_law	Common_law
Category:Communication	Category:Society	Communication
Category:Communication_design	Category:Business Category:Communication Category:Media_studies	Communication_design
Category:Communication_skills_training	Category:Communication Category:Training	Communication_skills_training
Category:Communication_theory	Category:Communication Category:Scientific_theories	Communication_theory
Category:Community_building	Category:Cultural_anthropology Category:Political_philosophy	Community_building
Category:Community_development	Category:Politics	Community_development
Category:Community_organizing	Category:Political_philosophy	Community_organizing
Category:Comorian_society	Category:Society	Comorian_society
Category:Companies	Category:Business	Company
Category:Company_logos	Category:Companies	Logo
Category:Comparative_education	Category:Education_theory	Comparative_education
Category:Comparative_law	Category:Law	Comparative_law
Category:Comparative_politics	Category:Politics	Comparative_politics
Category:Competition	Category:Marketing	Competition
Category:Competition_law	Category:Business_law Category:Law	Competition_law
Category:Complex_systems_theory	Category:Interdisciplinary_fields	Complex_systems
Category:Composting	Category:Agriculture	Compost
Category:Computational_biology	Category:Computational_science	Computational_biology
Category:Computational_chemistry	Category:Computational_science	Computational_chemistry
Category:Computational_fluid_dynamics	Category:Computational_science	Computational_fluid_dynamics
Category:Computational_geometry	Category:Computational_science	Computational_geometry
Category:Computational_linguistics	Category:Computational_science Category:Interdisciplinary_fields Category:Language Category:Linguistics	Computational_linguistics
Category:Computational_neuroscience	Category:Computational_science	Computational_neuroscience
Category:Computational_physics	Category:Computational_science	Computational_physics
Category:Computational_science	Category:Science	Computational_science
Category:Computational_topology	Category:Computational_science	Computational_topology
Category:Computer-assisted_translation	Category:Language	Computer-assisted_translation
Category:Computer_jargon	Category:Language	Jargon
Category:Computer_law	Category:Law	Legal_aspects_of_computing
Category:Computer-mediated_communication	Category:Communication	Computer-mediated_communication
Category:Computer_scientists	Category:Scientists	Computer_science
Category:Computer_systems	Category:Technology_systems	Computer
Category:Condensed_matter_physics	Category:Matter	Condensed_matter_physics
Category:Confidence_tricks	Category:Business_ethics	Confidence_trick
Category:Conflict_of_laws	Category:Law	Conflict_of_laws
Category:Confucianism	Category:Political_philosophy	Confucianism
Category:Congenital_disorders	Category:Disability Category:Health	Congenital_disorder
Category:Constituencies	Category:Elections	Electoral_district
Category:Constitutional_law	Category:Law	Constitutional_law
Category:Constructed_languages	Category:Languages	Constructed_language
Category:Construction_equipment	Category:Equipment	Heavy_equipment_%28construction%29
Category:Consumer_behaviour	Category:Business	Consumer_behaviour
Category:Consumer_organizations	Category:Business_organizations	Consumer_organization
Category:Consumer_theory	Category:Marketing	Consumer_choice
Category:Contemporary_history	Category:History	Contemporary_history
Category:Continents	Category:Earth Category:Geography	Continent
Category:Contract_law	Category:Business_law Category:Common_law	Contract
Category:Control_engineering	Category:Technology_systems	Control_engineering
Category:Controlled_vocabularies	Category:Terminology Category:Vocabulary	Controlled_vocabulary
Category:Convenience_foods	Category:Consumer_behaviour	Convenience_food
Category:Cooking	Category:Gastronomy Category:Home	Cooking
Category:Cooking_utensils	Category:Tools	List_of_food_preparation_utensils
Category:Cooperative_principles	Category:Business_ethics	Rochdale_Principles
Category:Cooperatives	Category:Law	Cooperative
Category:Copyright_law	Category:Law	Copyright
Category:Corporate_crime	Category:Companies	Corporate_crime
Category:Corporate_governance	Category:Management	Corporate_governance
Category:Corporate_groups	Category:Society	Corporate_group
Category:Corporate_scandals	Category:Business_ethics	List_of_corporate_scandals
Category:Corporations	Category:Corporate_groups Category:Law	Corporation
Category:Corporations_law	Category:Business_law Category:Companies	Corporate_law
Category:Corporatism	Category:Culture Category:Political_philosophy Category:Politics	Corporatism
Category:Corpus_linguistics	Category:Linguistics	Corpus_linguistics
Category:Corruption_by_country	Category:Political_corruption	Corruption_Perceptions_Index
Category:Cotton	Category:Crops	Cotton
Category:Counter-revolutionaries	Category:Politics	Counter-revolutionary
Category:Countries	Category:Earth Category:Geography	Country
Category:Country_codes	Category:Geocodes	Country_code
Category:Country_subdivisions	Category:Geography	Administrative_division
Category:Court_reporting	Category:Jurists	Court_reporter
Category:Courts_of_chancery	Category:Law	Court_of_Chancery
Category:Creative_works	Category:Arts	Creative_work
Category:Crime	Category:Law_enforcement Category:Society	Crime
Category:Crimes	Category:Crime	Crime
Category:Criminal_justice	Category:Crime	Criminal_justice
Category:Criminal_law	Category:Common_law Category:Law	Criminal_law
Category:Criminals	Category:Crime	Crime
Category:Criminology	Category:Crime Category:Law_enforcement	Criminology
Category:Crisis	Category:History	Crisis
Category:Critical_pedagogy	Category:Philosophy_of_education	Critical_pedagogy
Category:Critical_theory	Category:Political_philosophy	Critical_theory
Category:Critical_thinking	Category:Learning Category:Life_skills	Critical_thinking
Category:Criticism_of_religion	Category:Religion	Criticism_of_religion
Category:Croatian_history	Category:History	History_of_Croatia
Category:Crops	Category:Agriculture Category:Agronomy Category:Domesticated_plants	Crop
Category:Cross-cultural_studies	Category:Cultural_anthropology Category:Politics	Cross-cultural_studies
Category:Crowds	Category:Sociology	Crowds
Category:Cuisine	Category:Food_and_drink Category:Gastronomy	Cuisine
Category:Culinary_Arts	Category:Gastronomy	Culinary_art
Category:Cultivars	Category:Domesticated_plants	Cultivar
Category:Cultural_anthropologists	Category:Cultural_anthropology	Cultural_anthropology
Category:Cultural_anthropology	Category:Culture	Cultural_anthropology
Category:Cultural_appropriation	Category:Globalization	Cultural_appropriation
Category:Cultural_assimilation	Category:Culture Category:Ethnicity Category:Politics Category:Sociology	Cultural_assimilation
Category:Cultural_geography	Category:Culture Category:Human_geography	Cultural_geography
Category:Cultural_heritage	Category:Cultural_history Category:Ethnicity	Cultural_heritage
Category:Cultural_history	Category:Culture Category:History Category:Museology	Cultural_history
Category:Cultural_landscapes	Category:Landscape	Cultural_landscape
Category:Cultural_studies	Category:Culture Category:Interdisciplinary_fields Category:Social_sciences	Cultural_studies
Category:Cultural_trends	Category:Culture Category:Phenomena	Bandwagon_effect
Category:Culture	Category:Society	Culture
Category:Culture-bound_syndromes	Category:Culture	Culture-bound_syndrome
Category:Culture_by_region	Category:Culture	Culture_by_region
Category:Cultures	Category:Culture	Culture
Category:Curators	Category:Education	Curator
Category:Curricula	Category:Education	Curriculum
Category:Cutting_tools	Category:Tools	Cutting_tool_%28machining%29
Category:Cyberinfrastructure	Category:Technology	Cyberinfrastructure
Category:Cybernetics	Category:Interdisciplinary_fields Category:Technology	Cybernetics
Category:Dairy_farming	Category:Agriculture	Dairy_farming
Category:Damnatio_memoriae	Category:History	Damnatio_memoriae
Category:Dance	Category:Entertainment Category:Performing_arts	Dance
Category:Dance_education	Category:Culture Category:Education	Dance_education
Category:Dance_organizations	Category:Arts	Dance
Category:Dance_related_lists	Category:Arts	Dance
Category:Dark_matter	Category:Matter	Dark_matter
Category:Darmstadt_University_of_Technology	Category:Technology	Darmstadt_University_of_Technology
Category:Data_collection	Category:Procurement	Data_collection
Category:Data_mining	Category:Business_intelligence	Data_mining
Category:Data_warehousing	Category:Business_intelligence	Data_warehouse
Category:Dating	Category:Society	Dating
Category:Dating_methods	Category:Chronology	Geochronology
Category:Days	Category:Chronology	Day
Category:Deaf_studies	Category:Area_studies	Deaf_studies
Category:Debates	Category:Society	Debate
Category:Debating	Category:Political_communication	Debate
Category:Decades	Category:Chronology	List_of_decades
Category:Declarations_of_independence	Category:Historical_documents	Declaration_of_independence
Category:Deconstruction	Category:Philosophy_of_language	Deconstruction
Category:Defectors	Category:Politics	Defection
Category:Definition	Category:Philosophy_of_language	Definition
Category:Demidov_Prize	Category:Science Category:Technology	Demidov_Prize
Category:Democratic_education	Category:Alternative_education Category:Education_theory	Democratic_education
Category:Demographics	Category:Sociology	Demographics
Category:Demography	Category:Culture	Demography
Category:Denialism	Category:Politics	Denialism
Category:Dentistry	Category:Health_sciences	Dentistry
Category:Design	Category:Aesthetics Category:Visual_arts	Design
Category:Design_history	Category:Cultural_history Category:History	Design_history
Category:Design_of_experiments	Category:Scientific_method	Design_of_experiments
Category:Developmental_disabilities	Category:Disability	Developmental_disability
Category:Developmental_dyslexia	Category:Communication	Dyslexia
Category:Dialectic	Category:Rhetoric	Dialectic
Category:Dialectology	Category:Linguistics	Dialectology
Category:Dietitians	Category:Health	Dietitian
Category:Digital_dictation	Category:Language	Digital_dictation
Category:Digital_Humanities	Category:Humanities	Digital_humanities
Category:Digital_technology	Category:Technology	Digital_electronics
Category:Dimension	Category:Universe	Dimension
Category:Dining_clubs	Category:Society	Dining_club
Category:Dioceses	Category:Business	Diocese
Category:Direct_marketing	Category:Business	Direct_marketing
Category:Disability	Category:Health Category:Society	Disability
Category:Disability_rights	Category:Disability	Disability_rights_movement
Category:Disabled_sports	Category:Disability	Disabled_sports
Category:Disasters	Category:History	Disaster
Category:Discourse_analysis	Category:Linguistics	Discourse_analysis
Category:Disengagement_from_religion	Category:Society	Religious_disaffiliation
Category:Disinfectants	Category:Hygiene	Disinfectant
Category:Dissent	Category:Political_activism	Dissent
Category:Distance_education	Category:Alternative_education Category:Education Category:Educational_technology	Distance_education
Category:Documentary_films	Category:Education	Documentary_film
Category:Dog_health	Category:Veterinary_medicine	Dog_health
Category:Dogs	Category:Domesticated_animals	Dog
Category:Do_it_yourself	Category:Arts	Do_it_yourself
Category:Domesticated_animals	Category:Agriculture Category:Culture	List_of_domesticated_animals
Category:Domesticated_birds	Category:Domesticated_animals	List_of_domesticated_animals
Category:Domesticated_plants	Category:Agriculture	List_of_domesticated_plants
Category:Domestic_violence	Category:Society	Domestic_violence
Category:Donkeys	Category:Domesticated_animals	Donkey
Category:Doors_Open_Days	Category:Culture	Doors_Open_Days
Category:Down_syndrome	Category:Disability	Down_syndrome
Category:Drama	Category:Entertainment Category:Humanities Category:Performing_arts	Drama
Category:Dramatic_portrayals_of_Jesus	Category:Drama	Cultural_depictions_of_Jesus
Category:Drawing	Category:Arts	Drawing
Category:Dresden_University_of_Technology	Category:Technology	Dresden_University_of_Technology
Category:Drinking_culture	Category:Cultures	Drinking_culture
Category:Driver_training	Category:Training Category:Vocational_education	Driver%27s_education
Category:Droughts	Category:Nature	Drought
Category:Drug_control_law	Category:Law	Drug_prohibition_law
Category:Drug_policy	Category:Health_policy	Drug_policy
Category:Drug_policy_reform	Category:Legal_reform	Drug_policy_reform
Category:Dune_technology	Category:Fictional_technology	Technology_of_the_Dune_universe
Category:Dyslexia	Category:Health	Dyslexia
Category:Dysphemisms	Category:Vocabulary	Dysphemism
Category:Early_childhood_education	Category:Education	Early_childhood_education
Category:Earth	Category:Geography Category:Nature	Earth
Category:Earth_in_fiction	Category:Earth	Earth_in_science_fiction
Category:Earth_orbits	Category:Earth	Geocentric_orbit
Category:Earth_sciences	Category:Earth Category:Natural_sciences	Earth_science
Category:Ecological_theories	Category:Scientific_theories	Theoretical_ecology
Category:Econometrics	Category:Economics	Econometrics
Category:Economic_efficiency	Category:Business	Economic_efficiency
Category:Economic_geography	Category:Geography Category:Human_geography	Economic_geography
Category:Economic_history	Category:Economics Category:History	Economic_history
Category:Economic_inequality	Category:Society Category:Socioeconomics	Economic_inequality
Category:Economic_liberalization	Category:Globalization	Economic_liberalization
Category:Economic_policy	Category:Economics Category:Politics	Economic_policy
Category:Economics	Category:Social_sciences Category:Society	Economics
Category:Economics_education	Category:Education	Economics_education
Category:Economic_sociology	Category:Socioeconomics	Economic_sociology
Category:Economic_systems	Category:Economics Category:Social_institutions	Economics
Category:Economic_theories	Category:Scientific_theories	Economics
Category:Edible_plants	Category:Agronomy	List_of_plants_with_edible_leaves
Category:Editing	Category:Writing	Editing
Category:Editors	Category:Literature	Editors_%28band%29
Category:Education	Category:Social_institutions Category:Society	Education
Category:Educational_leadership	Category:Business Category:Education	Educational_leadership
Category:Educational_policies_and_initiatives_of_the_European_Union	Category:Education_policy	Educational_policies_and_initiatives_of_the_European_Union
Category:Educational_programs	Category:Education	Educational_program
Category:Educational_psychology	Category:Education	Educational_psychology
Category:Educational_research	Category:Education	Educational_research
Category:Educational_technology	Category:Education Category:Technology	Educational_technology
Category:Educational_television	Category:Education Category:Educational_technology	Educational_television
Category:Education_by_country	Category:Education	List_of_education_articles_by_country
Category:Educationists	Category:Education Category:Philosophy_of_education	Education
Category:Education_law	Category:Education_policy Category:Law	Education_policy
Category:Education_policy	Category:Education Category:Politics	Education_policy
Category:Education_reform	Category:Alternative_education Category:Education Category:Education_policy	Education_reform
Category:Education_theory	Category:Education	Education_theory
Category:Educators	Category:Education Category:Teaching	Teacher
Category:Egyptology	Category:Archaeology Category:Area_studies	Egyptology
Category:Election_fraud	Category:Elections Category:Political_corruption	Electoral_fraud
Category:Election_law	Category:Elections	Election_law
Category:Elections	Category:Government Category:Politics	Election
Category:Elections_by_country	Category:Elections Category:Politics	Elections_by_country
Category:Election_technology	Category:Elections	Election_technology
Category:Electoral_geography	Category:Elections Category:Human_geography	Electoral_geography
Category:Electoral_reform	Category:Elections	Electoral_reform
Category:Electoral_systems	Category:Elections	Voting_system
Category:Electric_power	Category:Energy	Electric_power
Category:Electronic_commerce	Category:Commerce	Electronic_commerce
Category:Electronic_music_instruments	Category:Inventions	Electronic_musical_instrument
Category:Electronics	Category:Technology	Electronics
Category:Emergency_management	Category:Management	Emergency_management
Category:Emergency_medical_services	Category:Healthcare	Emergency_medical_services
Category:Emergency_medical_technicians	Category:Health	Emergency_medical_technician
Category:Emerging_technology	Category:Technological_change Category:Technology	Emerging_technologies
Category:Empiricism	Category:Philosophy_of_science	Empiricism
Category:Employer_associations	Category:Business_organizations	Employers%27_organization
Category:Employment	Category:Management Category:Socioeconomics	Employment
Category:Employment_law	Category:Industrial_relations Category:Law	Labour_law
Category:Endangered_languages	Category:Languages	Endangered_language
Category:Energy	Category:Society Category:Technology	Energy
Category:Energy_conversion	Category:Energy	Energy_transformation
Category:Energy_development	Category:Energy	Energy_development
Category:Energy_economics	Category:Energy Category:Natural_resources	Energy_economics
Category:Energy_infrastructure	Category:Energy	Energy_development
Category:Energy_law	Category:Law	Energy_law
Category:Energy_policy	Category:Energy	Energy_policy
Category:Energy_production	Category:Energy	Energy_development
Category:Energy_recovery	Category:Energy	Energy_recovery
Category:Energy_sources	Category:Energy	Energy_development
Category:Energy_storage	Category:Energy	Energy_storage
Category:Energy_technology	Category:Energy Category:Technology	Energy_technology
Category:Engineering_education	Category:Education	Engineering_education
Category:Engineering_statistics	Category:Operations_research	Engineering_statistics
Category:Engines	Category:Technology_systems	Engine
Category:Enterprise_modelling	Category:Business_models	Enterprise_modelling
Category:Entertainment	Category:Culture Category:Humanities	Entertainment
Category:Entertainment_journalism	Category:Entertainment	Entertainment_journalism
Category:Entrepreneurship	Category:Business	Entrepreneurship
Category:Environmental_design	Category:Agriculture	Environmental_design
Category:Environmental_economics	Category:Business_ethics Category:Economics	Environmental_economics
Category:Environmental_education	Category:Education	Environmental_education
Category:Environmental_health	Category:Health	Environmental_health
Category:Environmental_history	Category:History	Environmental_history
Category:Environmental_law	Category:Law	Environmental_law
Category:Environmental_technology	Category:Technology	Environmental_technology
Category:Epidemiology	Category:Health_sciences	Epidemiology
Category:Epistemology	Category:Science_studies	Epistemology
Category:Equality_rights	Category:Society	Social_equality
Category:Equipment	Category:Technology	Tool
Category:Erotica	Category:Performing_arts	Erotica
Category:ERP_software	Category:Business_software	Enterprise_resource_planning
Category:E-Science	Category:Computational_science	E-Science
Category:Esperanto_movement	Category:Culture	Esperanto_culture
Category:Ethical_banking	Category:Business_ethics	Ethical_banking
Category:Ethical_investment	Category:Business_ethics	Socially_responsible_investing
Category:Ethics	Category:Social_institutions	Ethics
Category:Ethnic_conflict	Category:Ethnicity	Ethnic_conflict
Category:Ethnic_groups	Category:Corporate_groups Category:Ethnicity	Ethnic_group
Category:Ethnic_humor	Category:Ethnicity	Ethnic_joke
Category:Ethnicity	Category:Culture	Ethnic_group
Category:Ethnic_studies	Category:Ethnicity Category:Humanities Category:Interdisciplinary_fields	Ethnic_studies
Category:Ethnography	Category:Archaeology Category:Ethnicity Category:Ethnic_studies Category:Interdisciplinary_fields	Ethnography
Category:ETH_Zurich	Category:Technology	ETH_Zurich
Category:Eugenics	Category:Health	Eugenics
Category:European_studies	Category:Area_studies	European_studies
Category:European_Union_law	Category:Law	European_Union_law
Category:European_Union_legislative_procedure	Category:Statutory_law	Legislature_of_the_European_Union
Category:Evidence-based_medicine	Category:Medicine	Evidence-based_medicine
Category:Evidence_law	Category:Common_law Category:Law	Evidence_%28law%29
Category:Evolution	Category:Nature Category:Phenomena Category:Scientific_theories	Evolution
Category:Evolutionary_computation	Category:Evolution	Evolutionary_computation
Category:Evolutionary_psychology	Category:Interdisciplinary_fields	Evolutionary_psychology
Category:Evolution_of_language	Category:Evolution	Origin_of_language
Category:Examinations	Category:Education	Test_%28assessment%29
Category:Exercise	Category:Health	Physical_exercise
Category:Exhibitions	Category:Communication Category:Culture Category:Museology	Exhibition
Category:Exotic_matter	Category:Matter	Exotic_matter
Category:Experiential_learning	Category:Philosophy_of_education	Experiential_learning
Category:Experimental_archaeology	Category:Historiography	Experimental_archaeology
Category:Experimental_mathematics	Category:Scientific_method	Experimental_mathematics
Category:Experiments	Category:Scientific_method	Experiment
Category:Exploration	Category:Geography Category:Social_history	Exploration
Category:Exploration_of_Africa	Category:Exploration	European_exploration_of_Africa
Category:Exploration_of_Australia	Category:Exploration	European_exploration_of_Australia
Category:Exploration_of_North_America	Category:Exploration	Exploration_of_North_America
Category:Exploratory_engineering	Category:Fictional_technology	Exploratory_engineering
Category:Explorers	Category:Exploration	Exploration
Category:Explosives	Category:Technology	Explosive_material
Category:Extrajudicial_prisoners_of_the_United_States	Category:Law	Extrajudicial_prisoners_of_the_United_States
Category:Factitious_disorders	Category:Culture-bound_syndromes	Factitious_disorder
Category:Fads	Category:Cultural_trends	Fad
Category:Fair_division	Category:Law	Fair_division
Category:Fair_trade	Category:Business_ethics	Fair_trade
Category:Fairy_tales	Category:Arts	Fairy_tale
Category:False_advertising	Category:Business_ethics	False_advertising
Category:Families	Category:Family	Family
Category:Family	Category:Corporate_groups Category:Social_institutions Category:Society	Family
Category:Family_law	Category:Family Category:Law Category:Society	Family_law
Category:Family_therapy	Category:Family	Family_therapy
Category:Famines	Category:Food_and_drink	Famine
Category:Fan_clubs	Category:Society	Fan_club
Category:FAQ	Category:Technical_communication	FAQ
Category:Farmers	Category:Agriculture	Farmer
Category:Farms	Category:Agricultural_land Category:Agriculture	Farm
Category:Fascism	Category:Culture Category:Politics	Fascism
Category:Fashion	Category:Clothing Category:Cultural_trends	Fashion
Category:Fashion_accessories	Category:Clothing	Fashion_accessory
Category:Faster-than-light_communication	Category:Fictional_technology	Superluminal_communication
Category:Faster-than-light_travel	Category:Science	Faster-than-light
Category:Fault_tolerance	Category:Business	Fault-tolerant_design
Category:Federal_Emergency_Management_Agency	Category:Law	Federal_Emergency_Management_Agency
Category:Feminine_hygiene	Category:Hygiene	Feminine_hygiene
Category:Feminist_criticism	Category:Society	Feminist_criticism
Category:Feminist_theory	Category:Gender_studies	Feminist_theory
Category:Ferrets	Category:Domesticated_animals	Ferret
Category:Fertilizers	Category:Agricultural_chemicals Category:Agriculture Category:Agronomy	Fertilizer
Category:Festivals	Category:Culture Category:Society	Festival
Category:Fibers	Category:Natural_materials	Fiber
Category:Fiction	Category:Literature	Fiction
Category:Fictional_currencies	Category:Society	Fictional_currency
Category:Fictional_languages	Category:Society	Fictional_language
Category:Fictional_locations	Category:Geography	Fictional_location
Category:Fictional_technology	Category:Science Category:Technology	Fictional_technology
Category:Film	Category:Entertainment	Film
Category:Film_awards	Category:Arts	List_of_film_awards
Category:Film_theory	Category:Aesthetics	Film_theory
Category:Finance	Category:Business	Finance
Category:Financial_accounting	Category:Finance	Financial_accountancy
Category:Financial_economics	Category:Economics Category:Finance	Financial_economics
Category:Financial_system	Category:Finance	Financial_system
Category:FIPS_10	Category:Geocodes	FIPS_10
Category:First_aid	Category:Medicine	First_aid
Category:Flags	Category:Cultural_history	Flag
Category:Flat_Earth_theory	Category:Earth	Flat_Earth
Category:Flight_training	Category:Training	Flight_training
Category:Flood	Category:Natural_hazards	Flood
Category:Floristry	Category:Agriculture	Floristry
Category:Florists	Category:Agriculture	Floristry
Category:Fodder	Category:Crops	Fodder
Category:Folklore	Category:Cultural_anthropology Category:Traditions	Folklore
Category:Folk_museums	Category:History Category:Social_history Category:Society	Open-air_museum
Category:Food_allergies	Category:Food_and_drink	Food_allergy
Category:Food_and_Agriculture_Organization	Category:Agriculture	Food_and_Agriculture_Organization
Category:Food_and_drink	Category:Gastronomy Category:Health	Food
Category:Food_culture	Category:Cultures Category:Food_and_drink	Index_of_sociology_of_food_articles
Category:Food_industry	Category:Food_and_drink	Food_industry
Category:Food_law	Category:Food_and_drink Category:Law	Food_libel_laws
Category:Food_museums	Category:Food_and_drink	Food_museum
Category:Food_riots	Category:Food_and_drink	Food_riot
Category:Foods	Category:Food_and_drink	Food
Category:Food_safety	Category:Food_and_drink	Food_safety
Category:Food_science	Category:Interdisciplinary_fields	Food_science
Category:Foot_diseases	Category:Health	Foot
Category:Force	Category:Universe	Force
Category:Forced_disappearance	Category:History	Forced_disappearance
Category:Foreign_direct_investment	Category:International_business	Foreign_direct_investment
Category:Forensic_entomology	Category:Interdisciplinary_fields	Forensic_entomology
Category:Forensics	Category:Law Category:Law_enforcement	Forensic_science
Category:Forensic_scientists	Category:Scientists	Forensic_science
Category:Forensic_software	Category:Science	List_of_digital_forensics_tools
Category:Forestry	Category:Agriculture	Forestry
Category:Formal_sciences	Category:Interdisciplinary_fields Category:Logic Category:Science	Formal_sciences
Category:Former_constellations	Category:History	Former_constellations
Category:Forms_of_energy	Category:Energy	Forms_of_energy
Category:Foster_care	Category:Family	Foster_care
Category:Fraud	Category:Business_ethics	Fraud
Category:Freedom_of_religion	Category:Society	Freedom_of_religion
Category:Free_love	Category:Mating_systems Category:Society	Free_love
Category:Free_market	Category:Globalization	Free_market
Category:Freethought	Category:Political_philosophy	Freethought
Category:Fringe_science	Category:Science Category:Society	Fringe_science
Category:Fruit	Category:Crops	Fruit
Category:Fugitives	Category:Law_enforcement	Fugitive
Category:Furnishings	Category:Home	Decorative_arts
Category:Furniture	Category:Home	Furniture
Category:Future_history	Category:History	Future_history
Category:Futurology	Category:Social_change	Future_studies
Category:Gambling	Category:Entertainment	Gambling
Category:Gambling_regulation	Category:Law	Gaming_law
Category:Gangs	Category:Society	Gang
Category:Gardens	Category:Agriculture	Garden
Category:Garment_industry	Category:Clothing	Textile_manufacturing
Category:Gastronomy	Category:Culture	Gastronomy
Category:Gender	Category:Social_sciences Category:Society	Gender
Category:Gender_and_education	Category:Education Category:Education_policy Category:History_of_education	Gender_and_education
Category:Gender_and_religion	Category:Society	Gender_and_religion
Category:Gender-neutral_language	Category:Language	Gender-neutral_language
Category:Gender_studies	Category:Humanities	Gender_studies
Category:Genealogical_societies	Category:History Category:Society	Family_history_society
Category:Genealogy	Category:Cultural_history	Genealogy
Category:General_elections	Category:Elections	General_election
Category:Generative_linguistics	Category:Linguistics	Generative_linguistics
Category:Genetic_disorders	Category:Health	Genetic_disorder
Category:Genital_modification	Category:Society	Genital_modification_and_mutilation
Category:Genres	Category:Creative_works	Genre
Category:Geochronology	Category:Chronology	Geochronology
Category:Geocodes	Category:Geography	Geocode
Category:Geodemography	Category:Geography	Geodemography
Category:Geographers	Category:Geography	Geographer
Category:Geographical_naming_disputes	Category:Politics	Geographical_renaming
Category:Geographic_information_systems	Category:Geography	Geographic_information_system
Category:Geography	Category:Interdisciplinary_fields Category:Social_sciences	Geography
Category:George_Lucas	Category:Business	George_Lucas
Category:Georgia_Institute_of_Technology	Category:Technology	Georgia_Institute_of_Technology
Category:Geosocial_networking	Category:Social_media	Geosocial_networking
Category:Gifted_education	Category:Alternative_education	Gifted_education
Category:Giftedness	Category:Educational_psychology	Intellectual_giftedness
Category:Glass_art	Category:Arts	Glass_art
Category:Global_health	Category:Globalization	Global_health
Category:Globalism	Category:Globalization	Globalism
Category:Globalization	Category:Business Category:Global_politics Category:Politics Category:Society	Globalization
Category:Global_politics	Category:Globalization Category:Politics	Global_politics
Category:Global_warming	Category:Global_politics	Global_warming
Category:Golden_Bulls	Category:Historical_documents	Golden_Bull
Category:Google_acquisitions	Category:Mergers_and_acquisitions	List_of_acquisitions_by_Google
Category:Government	Category:Politics Category:Social_institutions	Government
Category:Government_bodies	Category:Organizations	Quango
Category:Government_corporations	Category:Government	Government-owned_corporation
Category:Government_officials	Category:Politics	Official
Category:Government_procurement	Category:Government Category:Procurement	Government_procurement
Category:Governments_in_exile	Category:Government	Government_in_exile
Category:Graduation	Category:Education	Graduation
Category:Grain_elevators	Category:Agriculture	Grain_elevator
Category:Grammar	Category:Language Category:Linguistics	Grammar
Category:Grammatical_gender	Category:Language Category:Vocabulary	Grammatical_gender
Category:Grape_varieties	Category:Viticulture	List_of_grape_varieties
Category:Graphology	Category:Writing	Graphology
Category:Greenhouses	Category:Agriculture	Greenhouse
Category:Grinding_mills	Category:Agriculture	Mill_%28grinding%29
Category:Group_processes	Category:Phenomena	Group_dynamics
Category:Growth_disorders	Category:Health	Growth_hormone_treatment
Category:Guilds	Category:Arts	Guild
Category:Gustation	Category:Aesthetics Category:Food_and_drink	Taste
Category:Habeas_corpus	Category:Law Category:Philosophy_of_law	Habeas_corpus
Category:Hadith	Category:Traditions	Hadith
Category:Hadrons	Category:Matter	Hadron
Category:Halls_of_fame	Category:Culture	Hall_of_fame
Category:Handicrafts	Category:Arts	Handicraft
Category:Hand_tools	Category:Tools	Hand_tool
Category:Harvest	Category:Agriculture	Harvest
Category:Harvest_festivals	Category:Agriculture Category:Harvest	Harvest_festival
Category:Hawaiian_studies	Category:Ethnic_studies	Hawaiian_studies
Category:Heads_of_state	Category:Politics	Head_of_state
Category:Health	Category:Interdisciplinary_fields Category:Society	Health
Category:Healthcare	Category:Health Category:Medicine	Health_care
Category:Healthcare_law	Category:Healthcare Category:Health_law	Health_law
Category:Healthcare_management	Category:Healthcare Category:Health_economics	Health_administration
Category:Healthcare_reform	Category:Healthcare Category:Health_policy Category:Politics	Health_care_reform
Category:Health_economics	Category:Health Category:Healthcare	Health_economics
Category:Health_education	Category:Education Category:Health Category:Healthcare	Health_education
Category:Health_fraud	Category:Healthcare	Quackery
Category:Health_in_Afghanistan	Category:Health	Health_in_Afghanistan
Category:Health_in_Algeria	Category:Health	Health_in_Algeria
Category:Health_in_Angola	Category:Health	Health_in_Angola
Category:Health_in_Antigua_and_Barbuda	Category:Health	Health_care_in_Antigua_and_Barbuda
Category:Health_in_Argentina	Category:Health	Health_care_in_Argentina
Category:Health_in_Australia	Category:Health	Health_care_in_Australia
Category:Health_in_Belarus	Category:Health	Healthcare_in_Belarus
Category:Health_in_Belgium	Category:Health	Healthcare_in_Belgium
Category:Health_in_Benin	Category:Health	Health_in_Benin
Category:Health_in_Bhutan	Category:Health	Health_in_Bhutan
Category:Health_in_Bolivia	Category:Health	Health_in_Bolivia
Category:Health_in_Brazil	Category:Health	Health_in_Brazil
Category:Health_in_Bulgaria	Category:Health	Health_in_Bulgaria
Category:Health_in_Burkina_Faso	Category:Health	Health_in_Burkina_Faso
Category:Health_in_Burma	Category:Health	Health_in_Burma
Category:Health_in_Burundi	Category:Health	Health_in_Burundi
Category:Health_in_Cameroon	Category:Health	Health_in_Cameroon
Category:Health_in_Canada	Category:Health	Health_care_in_Canada
Category:Health_in_Cape_Verde	Category:Health	Health_in_Cape_Verde
Category:Health_in_C%C3%B4te_d%27Ivoire	Category:Health	Health_in_C%C3%B4te_d%27Ivoire
Category:Health_in_Chad	Category:Health	Health_in_Chad
Category:Health_in_Comoros	Category:Health	Health_in_Comoros
Category:Health_in_Cuba	Category:Health	Healthcare_in_Cuba
Category:Health_in_Ecuador	Category:Health	Health_in_Ecuador
Category:Health_in_Egypt	Category:Health	Healthcare_in_Egypt
Category:Health_in_Equatorial_Guinea	Category:Health	Health_in_Equatorial_Guinea
Category:Health_in_Eritrea	Category:Health	Health_in_Eritrea
Category:Health_in_Europe	Category:Health	Healthcare_in_Europe
Category:Health_informatics	Category:Health	Health_informatics
Category:Health_in_France	Category:Health	Health_care_in_France
Category:Health_in_Germany	Category:Health	Health_in_Germany
Category:Health_in_Ghana	Category:Health	Health_in_Ghana
Category:Health_in_Greece	Category:Health	Health_care_in_Greece
Category:Health_in_Haiti	Category:Health	Health_in_Haiti
Category:Health_in_Hungary	Category:Health	Healthcare_in_Hungary
Category:Health_in_Iceland	Category:Health	Healthcare_in_Iceland
Category:Health_in_India	Category:Health	Healthcare_in_India
Category:Health_in_Indonesia	Category:Health	Health_in_Indonesia
Category:Health_in_Iran	Category:Health	Health_care_in_Iran
Category:Health_in_Iraq	Category:Health	Health_in_Iraq
Category:Health_in_Israel	Category:Health	Health_care_in_Israel
Category:Health_in_Italy	Category:Health	Health_in_Italy
Category:Health_in_Japan	Category:Health	Health_in_Japan
Category:Health_in_Jordan	Category:Health	Health_in_Jordan
Category:Health_in_Kazakhstan	Category:Health	Health_in_Kazakhstan
Category:Health_in_Kenya	Category:Health	Health_in_Kenya
Category:Health_in_Kyrgyzstan	Category:Health	Health_in_Kyrgyzstan
Category:Health_in_Laos	Category:Health	Health_in_Laos
Category:Health_in_Libya	Category:Health	Health_in_Libya
Category:Health_in_Malaysia	Category:Health	Healthcare_in_Malaysia
Category:Health_in_Mali	Category:Health	Health_in_Mali
Category:Health_in_Mexico	Category:Health	Health_care_in_Mexico
Category:Health_in_Morocco	Category:Health	Health_in_Morocco
Category:Health_in_Nepal	Category:Health	Health_in_Nepal
Category:Health_in_Nigeria	Category:Health	Health_care_in_Nigeria
Category:Health_in_North_Korea	Category:Health	Health_Care_in_North_Korea
Category:Health_in_Norway	Category:Health	Healthcare_in_Norway
Category:Health_in_Pakistan	Category:Health	Health_care_in_Pakistan
Category:Health_in_Paraguay	Category:Health	Health_in_Paraguay
Category:Health_in_Poland	Category:Health	Health_in_Poland
Category:Health_in_Portugal	Category:Health	Health_in_Portugal
Category:Health_in_Romania	Category:Health	Healthcare_in_Romania
Category:Health_in_Russia	Category:Health	Healthcare_in_Russia
Category:Health_in_Saudi_Arabia	Category:Health	Healthcare_in_Saudi_Arabia
Category:Health_in_Senegal	Category:Health	Health_in_Senegal
Category:Health_in_Sierra_Leone	Category:Health	Healthcare_in_Sierra_Leone
Category:Health_in_Singapore	Category:Health	Healthcare_in_Singapore
Category:Health_in_Slovenia	Category:Health	Healthcare_in_Slovenia
Category:Health_in_South_Africa	Category:Health	Healthcare_in_South_Africa
Category:Health_in_South_Korea	Category:Health	Health_in_South_Korea
Category:Health_in_Sudan	Category:Health	Health_in_Sudan
Category:Health_insurance	Category:Health	Health_insurance
Category:Health_insurance_in_the_United_States	Category:Health_insurance	Health_insurance_in_the_United_States
Category:Health_in_Sweden	Category:Health	Healthcare_in_Sweden
Category:Health_in_Switzerland	Category:Health	Healthcare_in_Switzerland
Category:Health_in_Syria	Category:Health	Health_in_Syria
Category:Health_in_Taiwan	Category:Health	Healthcare_in_Taiwan
Category:Health_in_Tajikistan	Category:Health	Health_in_Tajikistan
Category:Health_in_Thailand	Category:Health	Health_in_Thailand
Category:Health_in_the_Central_African_Republic	Category:Health	Health_in_the_Central_African_Republic
Category:Health_in_the_Democratic_Republic_of_the_Congo	Category:Health	Health_in_the_Democratic_Republic_of_the_Congo
Category:Health_in_the_Netherlands	Category:Health	Healthcare_in_the_Netherlands
Category:Health_in_the_People%27s_Republic_of_China	Category:Health	Public_health-care_in_China
Category:Health_in_the_Philippines	Category:Health	Health_in_the_Philippines
Category:Health_in_the_United_Arab_Emirates	Category:Health	Healthcare_in_the_United_Arab_Emirates
Category:Health_in_the_United_Kingdom	Category:Health	Healthcare_in_the_United_Kingdom
Category:Health_in_the_United_States	Category:Health	Health_care_in_the_United_States
Category:Health_in_Toronto	Category:Health	Health_in_Toronto
Category:Health_in_Turkey	Category:Health	Health_care_in_Turkey
Category:Health_in_Turkmenistan	Category:Health	Health_in_Turkmenistan
Category:Health_in_Uganda	Category:Health	Health_in_Uganda
Category:Health_in_Uzbekistan	Category:Health	Health_in_Uzbekistan
Category:Health_in_Venezuela	Category:Health	Health_care_in_Venezuela
Category:Health_in_Vietnam	Category:Health	Health_in_Vietnam
Category:Health_in_Yemen	Category:Health	Health_in_Yemen
Category:Health_law	Category:Health	Health_law
Category:Health_policy	Category:Health Category:Healthcare	Health_policy
Category:Health_promotion	Category:Business Category:Health Category:Healthcare Category:Health_policy	Health_promotion
Category:Health_sciences	Category:Health Category:Healthcare	Healthcare_science
Category:Heavy_equipment	Category:Equipment	Heavy_equipment_%28construction%29
Category:Hegemony	Category:Political_philosophy	Hegemony
Category:Heraldry	Category:Cultural_history	Heraldry
Category:Herbicides	Category:Agricultural_chemicals Category:Agriculture	Herbicide
Category:Heuristics	Category:Scientific_method	Heuristic
Category:Hibakusha	Category:Health	Hibakusha
Category:Higher_education	Category:Education	Higher_education
Category:High_IQ_societies	Category:Society	High_IQ_society
Category:Hill_figures	Category:Archaeology	Hill_figure
Category:Hindu_studies	Category:Study_of_religion	Hindu_studies
Category:Historians	Category:Historiography Category:History	List_of_historians
Category:Historical_comparative_research	Category:History	Historical_comparative_research
Category:Historical_documents	Category:History	Historical_document
Category:Historical_eras	Category:Chronology	History_by_period
Category:Historical_fiction	Category:History	Historical_fiction
Category:Historical_geography	Category:History Category:Human_geography	Historical_geography
Category:Historical_geology	Category:History	Historical_geology
Category:Historical_linguistics	Category:Linguistics Category:Philology	Historical_linguistics
Category:Historical_reenactment	Category:Historiography	Historical_reenactment
Category:Historical_regions	Category:History	Historical_region
Category:Historical_revisionism	Category:Historiography Category:History Category:Politics	Historical_revisionism
Category:Historical_revisionism_%28negationism%29	Category:Historiography	Historical_revisionism_%28negationism%29
Category:Historical_societies	Category:History	List_of_historical_societies
Category:Historic_districts	Category:Historic_preservation	Historic_districts_in_the_United_States
Category:Historic_preservation	Category:History	Historic_preservation
Category:Historiographers	Category:Historians Category:Historiography	Historiography
Category:Historiography	Category:History Category:Philosophy_of_history	Historiography
Category:Historiography_of_science	Category:Historiography Category:History_of_science	Historiography_of_science
Category:History	Category:Chronology Category:Humanities Category:Interdisciplinary_fields Category:Social_sciences	History
Category:History_by_period	Category:History	History_by_period
Category:History_of_agriculture	Category:Agriculture	History_of_agriculture
Category:History_of_Catalonia	Category:History	History_of_Catalonia
Category:History_of_clothing	Category:Clothing Category:Cultural_history	History_of_clothing_and_textiles
Category:History_of_communication	Category:Communication Category:History	History_of_communication
Category:History_of_computing	Category:History Category:History_of_technology	History_of_computing
Category:History_of_copyright_law	Category:Legal_history	History_of_copyright_law
Category:History_of_cryptography	Category:History_of_technology	History_of_cryptography
Category:History_of_dance	Category:History	History_of_dance
Category:History_of_education	Category:Cultural_history Category:Education Category:History	History_of_education
Category:History_of_engineering	Category:History	History_of_engineering
Category:History_of_film	Category:Cultural_history Category:History_of_technology	History_of_film
Category:History_of_Freemasonry	Category:History	History_of_Freemasonry
Category:History_of_games	Category:Cultural_history Category:History	History_of_games
Category:History_of_geography	Category:Geography Category:History	History_of_geography
Category:History_of_human_rights	Category:Human_rights Category:Legal_history	History_of_human_rights
Category:History_of_ideas	Category:History	History_of_ideas
Category:History_of_Indigenous_Australians	Category:History	History_of_Indigenous_Australians
Category:History_of_linguistics	Category:History Category:Linguistics	History_of_linguistics
Category:History_of_literature	Category:History Category:Literature	History_of_literature
Category:History_of_logic	Category:Logic	History_of_logic
Category:History_of_medicine	Category:History Category:Medicine	History_of_medicine
Category:History_of_philosophy	Category:Cultural_history Category:History	History_of_philosophy
Category:History_of_photography	Category:History Category:History_of_technology	History_of_photography
Category:History_of_poetry	Category:History	History_of_poetry
Category:History_of_political_thought	Category:Political_philosophy	History_of_political_thinking
Category:History_of_printing	Category:History_of_technology	History_of_printing
Category:History_of_rail_transport	Category:History_of_technology	History_of_rail_transport
Category:History_of_religion	Category:Cultural_history Category:History Category:Religion Category:Study_of_religion	History_of_religions
Category:History_of_science	Category:History Category:Philosophy_of_science Category:Science Category:Science_studies Category:Society	History_of_science
Category:History_of_science_and_technology_in_China	Category:History_of_science Category:History_of_technology	History_of_science_and_technology_in_China
Category:History_of_scientific_method	Category:History_of_science Category:Scientific_method	History_of_scientific_method
Category:History_of_slavery	Category:History Category:Social_history	History_of_slavery
Category:History_of_socialism	Category:History	History_of_socialism
Category:History_of_sports	Category:Cultural_history Category:History	History_of_sport
Category:History_of_statistics	Category:History_of_science	History_of_statistics
Category:History_of_technology	Category:History Category:History_of_science Category:Technology	History_of_technology
Category:History_of_telecommunications	Category:History_of_technology	History_of_telecommunication
Category:History_of_theatre	Category:Cultural_history	History_of_theatre
Category:History_of_the_automobile	Category:History_of_technology	History_of_the_automobile
Category:History_of_the_Kurdish_people	Category:History	History_of_the_Kurdish_people
Category:History_of_the_petroleum_industry	Category:History_of_technology	Petroleum_industry
Category:History_of_the_Romanians	Category:History	Romanians
Category:History_of_the_Serbs	Category:History	History_of_the_Serbs
Category:History_of_the_steam_engine	Category:History_of_technology	History_of_the_steam_engine
Category:History_of_the_United_Nations	Category:Legal_history	History_of_the_United_Nations
Category:History_of_the_Zaza_people	Category:History	History_of_the_Zaza_people
Category:History_of_tobacco	Category:History	History_of_tobacco
Category:History_of_writing	Category:Writing	History_of_writing
Category:Holocaust_denial	Category:Historiography	Holocaust_denial
Category:Home	Category:Society	Home
Category:Home_appliances	Category:Home Category:Tools	Home_appliance
Category:Home_automation	Category:Automation Category:Home	Home_automation
Category:Home_composting	Category:Composting	Compost
Category:Home_economics	Category:Home	Home_economics
Category:Home_front_during_World_War_II	Category:Social_history	Home_front_during_World_War_II
Category:Homeopathy	Category:Medicine	Homeopathy
Category:Homeschooling	Category:Alternative_education Category:Philosophy_of_education	Homeschooling
Category:Horses	Category:Domesticated_animals	Horse
Category:Hospitality_industry	Category:Commerce	Hospitality_industry
Category:Hospitality_management	Category:Management	Hotel_manager
Category:House_of_Camondo	Category:Business	House_of_Camondo
Category:House_plants	Category:Agriculture	Houseplant
Category:Houses	Category:Home	House
Category:Housewives	Category:Family	Housewife
Category:Howard_Hughes	Category:Business	Howard_Hughes
Category:How-to	Category:Education	How-to
Category:Human_appearance	Category:Aesthetics	Human_physical_appearance
Category:Human_communication	Category:Communication	Human_communication
Category:Human_Development_Index	Category:Socioeconomics	Human_Development_Index
Category:Human_geography	Category:Geography Category:Social_sciences Category:Society	Human_geography
Category:Humanities	Category:Culture Category:Interdisciplinary_fields	Humanities
Category:Human_migration	Category:Culture Category:History Category:Human_geography	Human_migration
Category:Human_rights	Category:Politics Category:Rights Category:Society	Human_rights
Category:Human_rights_abuses	Category:Human_rights	Human_rights
Category:Human_rights_instruments	Category:Human_rights	International_human_rights_instruments
Category:Human_sciences	Category:Interdisciplinary_fields Category:Social_sciences	Human_science
Category:Human_trophy_collecting	Category:Culture	Human_trophy_collecting
Category:Humor	Category:Aesthetics Category:Entertainment	Humour
Category:Hunting	Category:Culture	Hunting
Category:Hydroponics	Category:Agriculture	Hydroponics
Category:Hygiene	Category:Health	Hygiene
Category:Hyperreality	Category:Interdisciplinary_fields Category:Media_studies Category:Reality	Hyperreality
Category:Hypotheses	Category:Scientific_method Category:Scientific_theories	Hypothesis
Category:IBM_acquisitions	Category:Mergers_and_acquisitions	List_of_mergers_and_acquisitions_by_IBM
Category:Idealism	Category:Political_philosophy	Idealism
Category:Identifiers	Category:Communication	Identifier
Category:Identity_politics	Category:Politics	Identity_politics
Category:Idioms	Category:Vocabulary	Idiom
Category:Illegal_drug_trade	Category:Commerce	Illegal_drug_trade
Category:Impeachment	Category:Government Category:Law	Impeachment
Category:Impeachment_in_the_United_States	Category:Impeachment	Impeachment_in_the_United_States
Category:Imperial_College_London	Category:Technology	Imperial_College_London
Category:Imperialism	Category:History Category:Political_philosophy	Imperialism
Category:Impresarios	Category:Arts	Impresario
Category:Incertae_sedis	Category:Scientific_classification	Incertae_sedis
Category:Incest	Category:Family	Incest
Category:Income_distribution	Category:Socioeconomics	Income_distribution
Category:Indian_classical_music	Category:Arts	Indian_classical_music
Category:Indigenous_land_rights	Category:Law	Indigenous_land_rights
Category:Indigenous_rights	Category:Rights	Indigenous_rights
Category:Individual_mandates	Category:Law	Individual_mandate
Category:Indology	Category:Area_studies	Indology
Category:Indonesian_society	Category:Society	Culture_of_Indonesia
Category:Inductive_reasoning	Category:Learning Category:Philosophy_of_science Category:Science Category:Scientific_method	Inductive_reasoning
Category:Industrial_agriculture	Category:Agriculture	Industrial_agriculture
Category:Industrial_archaeology	Category:Business Category:Technology	Industrial_archaeology
Category:Industrial_automation	Category:Automation	Automation
Category:Industrial_design	Category:Business Category:Technology	Industrial_design
Category:Industrial_engineering	Category:Business Category:Technology	Industrial_engineering
Category:Industrial_hygiene	Category:Hygiene	Occupational_hygiene
Category:Industrial_organization	Category:Business Category:Economics Category:Technology	Industrial_organization
Category:Industrial_policy	Category:Business Category:Technology	Industrial_policy
Category:Industrial_processes	Category:Business Category:Inventions Category:Phenomena Category:Technology	List_of_industrial_processes
Category:Industrial_relations	Category:Business Category:Business_law	Industrial_relations
Category:Industrial_Revolution	Category:Business Category:History_of_technology Category:Technology	Industrial_Revolution
Category:Infectious_diseases	Category:Health	Infectious_disease
Category:Information_and_communication_technologies_for_development	Category:Communication Category:Information_technology	Information_and_communication_technologies_for_development
Category:Information_appliances	Category:Equipment	Information_appliance
Category:Information_science	Category:Interdisciplinary_fields Category:Science_studies	Information_science
Category:Information_society	Category:Society Category:Technology	Information_society
Category:Information_systems	Category:Information_technology Category:Technology_systems	Information_systems
Category:Information_technology	Category:Technology	Information_technology
Category:Information_technology_management	Category:Information_technology	Information_technology_management
Category:Infotainment	Category:Entertainment	Infotainment
Category:Inks	Category:Writing	Ink
Category:Innovation	Category:Technological_change	Innovation
Category:Inns_of_Chancery	Category:Law	Inns_of_Chancery
Category:Inscriptions	Category:Writing	Epigraphy
Category:Insecticides	Category:Agricultural_chemicals	Insecticide
Category:Insolvency	Category:Business_law	Insolvency
Category:Inspirational_literature	Category:Arts Category:Literature	Inspirational_fiction
Category:Insurance_law	Category:Law	Insurance_law
Category:Intelligence	Category:Educational_psychology Category:Learning	Intelligence
Category:Interdisciplinary_fields	Category:Science	Interdisciplinarity
Category:Interlinguistics	Category:Linguistics	Interlinguistics
Category:International_business	Category:Business	International_business
Category:International_economics	Category:Economics	International_economics
Category:International_incidents	Category:History	International_incident
Category:Internationalization_and_localization	Category:Language	Internationalization_and_localization
Category:International_law	Category:Law	International_law
Category:International_relations	Category:Global_politics	International_relations
Category:International_trade	Category:Commerce Category:Globalization Category:International_business Category:Trade	International_trade
Category:Internet_activism	Category:Political_activism	Internet_activism
Category:Internet_slang	Category:Language	Internet_slang
Category:Internships	Category:Education Category:Vocational_education	Internship
Category:Intersectionality	Category:Gender_studies	Intersectionality
Category:Invasive_plant_species	Category:Agriculture	Invasive_species
Category:Inventions	Category:Technology	Invention
Category:Inventors	Category:Inventions	Invention
Category:Investment_agencies	Category:Commerce	Investment_promotion_agency
Category:Ions	Category:Matter	Ion
Category:Iraq_Inquiry	Category:Politics	Iraq_Inquiry
Category:Irredentism	Category:Culture	Irredentism
Category:Irrigation	Category:Agriculture Category:Agronomy Category:Industrial_agriculture	Irrigation
Category:Islamic_dress_controversy_in_Europe	Category:Society	Islamic_dress_in_Europe
Category:Islamic_geography	Category:History_of_geography	Geography_and_cartography_in_medieval_Islam
Category:Islam_sciences	Category:Interdisciplinary_fields Category:Study_of_religion	Islamic_studies
Category:ISO_3166	Category:Geocodes	ISO_3166
Category:Israeli_society	Category:Society	Demographics_of_Israel
Category:Japanese_aesthetics	Category:Aesthetics	Japanese_aesthetics
Category:Japanese_family	Category:Family	Japanese_family
Category:Japanese_history_textbook_controversies	Category:Historiography	Japanese_history_textbook_controversies
Category:Japanese_home	Category:Home	Housing_in_Japan
Category:Japanese_society	Category:Society	Culture_of_Japan
Category:Japanology	Category:Cultural_anthropology	Japanese_studies
Category:Jewish_history	Category:History	Jewish_history
Category:Jewish_languages	Category:Languages	Jewish_languages
Category:Jim_Henson_Company	Category:Business	The_Jim_Henson_Company
Category:Joel_family	Category:Business	Joel_family
Category:Joint_ventures	Category:Business_law	Joint_venture
Category:Jordanian_society	Category:Society	Culture_of_Jordan
Category:Journalism_education	Category:Education	Journalism_school
Category:Journalism_history	Category:History Category:Media_studies	History_of_journalism
Category:Journalism_schools	Category:Media_studies	Journalism_school
Category:Judgment_%28law%29	Category:Legal_terms	Judgment_%28law%29
Category:Jurists	Category:Law	Jurist
Category:Justice_ministries	Category:Law	Justice_ministry
Category:Kadoorie_family	Category:Business	Kadoorie_family
Category:Kannapolis,_North_Carolina	Category:Business Category:Technology	Kannapolis,_North_Carolina
Category:Karlsruhe_Institute_of_Technology	Category:Technology	Karlsruhe_Institute_of_Technology
Category:Kazimierz_Pu%C5%82aski_Technical_University_of_Radom	Category:Technology	Kazimierz_Pu%C5%82aski_Technical_University_of_Radom
Category:Kibbutzim	Category:Agriculture	Kibbutz
Category:Kinship_and_descent	Category:Cultural_anthropology	Kinship
Category:Kinship_terminology	Category:Terminology	Kinship_terminology
Category:Kitchen	Category:Gastronomy Category:Home	Kitchen
Category:Knowledge	Category:Learning	Knowledge
Category:Knowledge_management	Category:Management	Knowledge_management
Category:Krupp	Category:Business	Krupp
Category:Labour_law	Category:Industrial_relations Category:Law	Labour_law
Category:Labour_relations	Category:Business_ethics	Industrial_relations
Category:La_D%C3%A9fense	Category:Business	La_D%C3%A9fense
Category:Land_art	Category:Landscape	Land_art
Category:Landforms	Category:Geography	Landform
Category:Land_law	Category:Politics Category:Rights	Land_law
Category:Landmarks	Category:Geography Category:Human_geography	Landmark
Category:Landowners	Category:Businesspeople	Land_tenure
Category:Land_reform	Category:Legal_reform	Land_reform
Category:Landscape	Category:Geography	Landscape
Category:Landscape_architecture	Category:Agriculture Category:Landscape	Landscape_architecture
Category:Landscape_art	Category:Landscape	Landscape_art
Category:Landscape_ecology	Category:Landscape	Landscape_ecology
Category:Landscape_history	Category:History Category:Landscape	Landscape_history
Category:Landscape_photography	Category:Landscape	Landscape_photography
Category:Land_use	Category:Human_geography	Land_use
Category:Language	Category:Communication Category:Humanities	Language
Category:Language_acquisition	Category:Language Category:Learning	Language_acquisition
Category:Language_certification	Category:Education	Language_assessment
Category:Language_classification	Category:Linguistics	Language_family
Category:Language_contact	Category:Linguistics	Language_contact
Category:Language_disorders	Category:Speech_and_language_pathology	Language_disorder
Category:Language_families	Category:Languages	Language_family
Category:Language_games	Category:Language	Language_game
Category:Language_interpretation	Category:Communication Category:Linguistics	Language_interpretation
Category:Language_isolates	Category:Languages	Language_isolate
Category:Language_learning_software	Category:Language_acquisition Category:Language_software	Computer-assisted_language_learning
Category:Language_policy	Category:Education_policy Category:Language Category:Politics	Language_policy
Category:Languages	Category:Communication Category:Culture Category:Language	Language
Category:Language_software	Category:Language	Computer-assisted_language_learning
Category:Laotian_society	Category:Society	Laotian_society
Category:LaRouche_movement	Category:Political_organizations	LaRouche_movement
Category:Law	Category:Government Category:Social_institutions	Law
Category:Law_by_country	Category:Law	List_of_country_legal_systems
Category:Law_dictionaries	Category:Legal_research	Law_dictionary
Category:Law_enforcement	Category:Law Category:Legal_action	Law_enforcement
Category:Law_enforcement_agencies	Category:Law_enforcement	Law_enforcement_agency
Category:Law_firms	Category:Law Category:Practice_of_law	Law_firm
Category:Law_journals	Category:Humanities Category:Law Category:Legal_research	Law_review
Category:Law_libraries	Category:Law Category:Legal_research	Law_library
Category:Law_societies	Category:Law	Law_society
Category:Lawsuits	Category:Law Category:Legal_action	Lawsuit
Category:Lawyers	Category:Jurists Category:Law	Lawyer
Category:Leadership	Category:Management Category:Political_activism Category:Political_philosophy	Leadership
Category:Leadership_studies	Category:Education Category:Social_sciences	Leadership_studies
Category:Learned_societies	Category:Society	Learned_society
Category:Learning	Category:Education	Learning
Category:Learning_disabilities	Category:Disability Category:Educational_psychology Category:Learning	Learning_disability
Category:Learning_management_systems	Category:Educational_technology Category:Learning	Learning_management_system
Category:Learning_psychology	Category:Learning	Psychology_of_learning
Category:Learning_theory_%28education%29	Category:Educational_psychology	Learning_theory_%28education%29
Category:Leasing	Category:Finance	Leasing
Category:Lecture_series	Category:Education	Public_lecture
Category:Legal_action	Category:Law	Law
Category:Legal_aid	Category:Law	Legal_aid
Category:Legal_codes	Category:Law Category:Statutory_law	Code_%28law%29
Category:Legal_costs	Category:Law	Costs_%28English_law%29
Category:Legal_education	Category:Education Category:Law	Legal_education
Category:Legal_fictions	Category:Law	Legal_fiction
Category:Legal_history	Category:History Category:Law	Legal_history
Category:Legal_issues_related_to_the_September_11_attacks	Category:Law	Legal_issues_related_to_the_September_11_attacks
Category:Legal_procedure	Category:Law	Procedural_law
Category:Legal_reform	Category:Law	Law_reform
Category:Legal_research	Category:Law	Legal_research
Category:Legal_terms	Category:Law Category:Terminology	Legal_year
Category:Legal_treatises	Category:Legal_research	Legal_treatise
Category:Legislatures	Category:Law	Legislature
Category:Lexicography	Category:Linguistics	Lexicography
Category:Lexicology	Category:Linguistics	Lexicology
Category:LGBT_culture	Category:Cultures	LGBT_culture
Category:LGBT_events	Category:Society	List_of_LGBT_events
Category:LGBT_history	Category:Social_history	LGBT_history
Category:LGBT_rights	Category:Politics	LGBT_rights_by_country_or_territory
Category:Liberalism	Category:Culture Category:Political_philosophy Category:Politics	Liberalism
Category:Libraries	Category:Culture Category:Education	Library
Category:Library_science	Category:Interdisciplinary_fields	Library_science
Category:Libyan_society	Category:Society	Demographics_of_Libya
Category:Life	Category:Phenomena Category:Universe	Life
Category:Life_extension	Category:Health	Life_extension
Category:Life_skills	Category:Education Category:Health Category:Philosophy_of_education	Life_skills
Category:Linear_programming	Category:Operations_research	Linear_programming
Category:Linens	Category:Home	Linens
Category:Linguistic_discrimination	Category:Language_policy	Linguistic_discrimination
Category:Linguistic_morphology	Category:Linguistics	Morphology_%28linguistics%29
Category:Linguistic_rights	Category:Language_policy	Linguistic_rights
Category:Linguistics	Category:Interdisciplinary_fields Category:Language Category:Social_sciences	Linguistics
Category:Linguistic_turn	Category:Philosophy_of_language	Linguistic_turn
Category:Linguistic_typology	Category:Linguistics	Linguistic_typology
Category:Lists_of_countries	Category:Geography	Lists_of_countries_and_territories
Category:Lists_of_diseases	Category:Health	Lists_of_diseases
Category:Lists_of_ecoregions	Category:Geography Category:Nature	Lists_of_ecoregions
Category:Lists_of_environmental_topics	Category:Nature	Lists_of_environmental_topics
Category:Lists_of_invasive_species	Category:Agriculture	Lists_of_invasive_species
Category:Lists_of_mountains	Category:Geography Category:Nature	Lists_of_mountains
Category:Lists_of_museums	Category:Culture Category:Education	List_of_museums
Category:Lists_of_political_parties	Category:Politics	List_of_political_parties
Category:Lists_of_political_parties_by_United_Nations_geoscheme	Category:Politics	List_of_political_parties_by_United_Nations_geoscheme
Category:Lists_of_unsolved_problems	Category:Science	List_of_unsolved_problems
Category:Lists_of_volcanoes	Category:Geography	Lists_of_volcanoes
Category:Literacy	Category:Socioeconomics Category:Writing	Literacy
Category:Literary_agencies	Category:Literature	Literary_agent
Category:Literary_agents	Category:Literature	Literary_agent
Category:Literary_awards	Category:Arts Category:Literature	Literary_award
Category:Literary_criticism	Category:Aesthetics Category:Literature	Literary_criticism
Category:Literary_devices	Category:Literature	Literary_technique
Category:Literary_genres	Category:Literature	Literary_genre
Category:Literary_societies	Category:Arts Category:Literature Category:Society	Literary_society
Category:Literary_techniques	Category:Literature	Literary_technique
Category:Literary_terms	Category:Literature Category:Terminology	Index_of_literary_terms
Category:Literature	Category:Arts Category:Humanities Category:Writing	Literature
Category:Live_Media	Category:Performing_arts	Live_CD
Category:Livestock	Category:Domesticated_animals	Livestock
Category:Living_museums	Category:History Category:Society	Open-air_museum
Category:Lobbying	Category:Political_corruption	Lobbying
Category:Local_government	Category:Government	Local_government
Category:Logic	Category:Interdisciplinary_fields Category:Science	Logic
Category:Logical_fallacies	Category:Logic	Fallacy
Category:Logical_positivism	Category:Philosophy_of_science	Logical_positivism
Category:Logical_syntax	Category:Logic	Syntax_%28logic%29
Category:Logicians	Category:Logic	School_of_Names
Category:Logistics	Category:Management	Logistics
Category:Lost_mines	Category:Archaeology	Lost_mines
Category:Lost_works	Category:Creative_works Category:Cultural_history	Lost_work
Category:Low-flow_irrigation_systems	Category:Irrigation	Low-flow_irrigation_systems
Category:Lubricants	Category:Technology	Lubricant
Category:Lubrication	Category:Technology	Lubrication
Category:Machine_learning	Category:Learning	Machine_learning
Category:Machinery	Category:Automation Category:Technology	Machine
Category:Machines	Category:Technology_systems	Machine
Category:Machine_translation	Category:Language	Machine_translation
Category:Magic_%28illusion%29	Category:Entertainment Category:Performing_arts	Magic_%28illusion%29
Category:Magic_%28paranormal%29	Category:Cultural_anthropology	Magic_%28paranormal%29
Category:Magic_realism	Category:Arts	Magic_realism
Category:Magic_words	Category:Language	Magic_word
Category:Malayan_Emergency	Category:Law	Malayan_Emergency
Category:Management	Category:Business	Management
Category:Management_accounting	Category:Management	Management_accounting
Category:Management_education	Category:Education Category:Management	Business_education
Category:Management_science	Category:Management Category:Operations_research	Operations_research
Category:Management_systems	Category:Management	Management_system
Category:Mantras	Category:Language	Mantra
Category:Manufacturing	Category:Business Category:Technology	Manufacturing
Category:Maps	Category:Geography	Map
Category:Maps_of_languages	Category:Languages	Linguistic_map
Category:Maritime_history	Category:History	Maritime_history
Category:Market_failure	Category:Business_ethics	Market_failure
Category:Marketing	Category:Business	Marketing
Category:Marketing_Analytics	Category:Business_intelligence Category:Marketing	Marketing_performance_measurement_and_management
Category:Market_research	Category:Marketing	Market_research
Category:Marriage	Category:Social_institutions Category:Society Category:Traditions	Marriage
Category:Martial_arts	Category:Arts	Martial_arts
Category:Marxist_historians	Category:Historians	Marxist_historiography
Category:Masonry	Category:Agriculture	Masonry
Category:Masques	Category:Drama	Masque
Category:Mass	Category:Matter	Mass
Category:Massachusetts_Institute_of_Technology	Category:Technology	Massachusetts_Institute_of_Technology
Category:Mass_media	Category:Communication Category:Entertainment	Mass_media
Category:Mathematical_economics	Category:Economics	Mathematical_economics
Category:Mathematical_induction	Category:Inductive_reasoning	Mathematical_induction
Category:Mathematical_logic	Category:Logic	Mathematical_logic
Category:Mathematical_optimization	Category:Operations_research	Mathematical_optimization
Category:Mathematicians	Category:Scientists	Mathematician
Category:Mathematics	Category:Science	Mathematics
Category:Mathematics_education	Category:Education	Mathematics_education
Category:Mating_systems	Category:Society	Mating_system
Category:Matriarchy	Category:Society	Matriarchy
Category:Matronymics	Category:Society	Matronymic
Category:Matter	Category:Nature Category:Universe	Matter
Category:M%C3%A9xico_Ind%C3%ADgena	Category:Human_geography	M%C3%A9xico_Ind%C3%ADgena
Category:Meals	Category:Food_and_drink	Meal
Category:Meaning-Text_Theory	Category:Linguistics	Meaning-Text_Theory
Category:Measuring_instruments	Category:Technology_systems Category:Tools	Measuring_instrument
Category:Meat_industry	Category:Agriculture	Livestock
Category:Meatpacking	Category:Meat_industry	Meat_packing_industry
Category:Media_influence	Category:Media_studies	Media_influence
Category:Media_studies	Category:Humanities Category:Interdisciplinary_fields Category:Social_sciences	Media_studies
Category:Medical_anthropology	Category:Medicine	Medical_anthropology
Category:Medical_diagnosis	Category:Medicine	Medical_diagnosis
Category:Medical_education	Category:Education Category:Health_education Category:Medicine Category:Vocational_education	Medical_education
Category:Medical_emergencies	Category:Health	Medical_emergency
Category:Medical_equipment	Category:Equipment Category:Medical_technology Category:Medicine	Medical_equipment
Category:Medical_genetics	Category:Interdisciplinary_fields	Medical_genetics
Category:Medical_informatics	Category:Health_informatics Category:Medicine	Health_informatics
Category:Medical_journalism	Category:Medicine	Medical_journalism
Category:Medical_jurisprudence	Category:Law Category:Medicine	Medical_jurisprudence
Category:Medical_law	Category:Law Category:Society	Medical_law
Category:Medical_libraries	Category:Medicine	Medical_library
Category:Medical_physics	Category:Medicine	Medical_physics
Category:Medical_research	Category:Health Category:Medicine	Medical_research
Category:Medical_sociology	Category:Medicine	Medical_sociology
Category:Medical_software	Category:Science	Medical_software
Category:Medical_statistics	Category:Health_economics	Medical_statistics
Category:Medical_technology	Category:Medicine Category:Technology	Medical_technology
Category:Medical_terms	Category:Medicine Category:Terminology	Medical_terminology
Category:Medical_tourism	Category:Healthcare Category:Health_economics	Medical_tourism
Category:Medicine	Category:Health Category:Healthcare Category:Health_sciences	Medicine
Category:Medicine_portal	Category:Medicine Category:Science	Portal:Medicine
Category:Medieval_drama	Category:Drama	Medieval_theatre
Category:Megastructures	Category:Fictional_technology	MegaStructures
Category:Memetics	Category:Cultural_anthropology Category:Evolution	Memetics
Category:Memorabilia	Category:History	Souvenir
Category:Men%27s_health	Category:Health	Men%27s_health
Category:Men%27s_rights	Category:Human_rights	Men%27s_rights
Category:Menier_family	Category:Business	Menier_family
Category:Mental_health	Category:Health	Mental_health
Category:Mental_retardation	Category:Disability	Mental_retardation
Category:Mercantile_law	Category:Business_law	Lex_mercatoria
Category:Merchandise	Category:Business	Good_%28economics%29
Category:Mergers_and_acquisitions	Category:Business	Mergers_and_acquisitions
Category:Mesons	Category:Matter	Meson
Category:Metalogic	Category:Logic	Metalogic
Category:Metalworking	Category:Arts	Metalworking
Category:Methodology	Category:Science	Methodology
Category:Metrication	Category:History_of_science	Metrication
Category:Michigan_Technological_University	Category:Technology	Michigan_Technological_University
Category:Microeconomics	Category:Economics	Microeconomics
Category:Micronations	Category:Politics Category:Society	Micronation
Category:Microsoft_acquisitions	Category:Mergers_and_acquisitions	List_of_mergers_and_acquisitions_by_Microsoft
Category:Microtechnology	Category:Technology	Microtechnology
Category:Middle_East_Technical_University	Category:Technology	Middle_East_Technical_University
Category:Midwives	Category:Health	Midwifery
Category:Military	Category:Society	Military
Category:Military_animals	Category:Domesticated_animals	Military_animal
Category:Military_art	Category:Military	Military_art
Category:Military_awards_and_decorations	Category:Military	Military_awards_and_decorations
Category:Military_education_and_training	Category:Education Category:Training Category:Vocational_education	Military_education_and_training
Category:Military_equipment	Category:Equipment	Military_technology
Category:Military_geography	Category:Geography	Military_geography
Category:Military_historiography	Category:Historiography	Military_history
Category:Military_history	Category:History Category:Military	Military_history
Category:Military_law	Category:Law Category:Military	Military_justice
Category:Military_officers	Category:Politics	Officer_%28armed_forces%29
Category:Military_operations	Category:Military	Military_operation
Category:Military_organization	Category:Military	Military_organization
Category:Military_personnel	Category:Military	Military_personnel
Category:Military_planning	Category:Military	Military_operation_plan
Category:Military_police	Category:Law_enforcement	Military_police
Category:Military_ranks	Category:Politics	Military_rank
Category:Military_science	Category:Military Category:Social_sciences	Military_science
Category:Military_technology	Category:Technology	Military_technology
Category:Military_terminology	Category:Military Category:Terminology	Military_terminology
Category:Military_theory	Category:Interdisciplinary_fields	Military_theory
Category:Millennia	Category:Chronology	Millennium
Category:Millennium_Development_Goals	Category:Socioeconomics	Millennium_Development_Goals
Category:Minerals	Category:Natural_materials Category:Natural_resources	Mineral
Category:Minority_governments	Category:Elections Category:Government	Minority_government
Category:Mobile_computers	Category:Mobile_technology	Mobile_computing
Category:Mobile_content	Category:Mobile_technology	Mobile_content
Category:Mobile_technology	Category:Technology Category:Wireless	Mobile_technology
Category:Mobile_telecommunications	Category:Mobile_technology	Mobile_telephony
Category:Mobile_television	Category:Mobile_technology	Mobile_television
Category:Mock_combat	Category:Performing_arts	Mock_combat
Category:Modeling_and_simulation	Category:Operations_research	Modeling_and_simulation
Category:Molecules	Category:Matter	Molecule
Category:Molson_family	Category:Business	Molson_family
Category:Monogamy	Category:Family Category:Mating_systems Category:Society	Monogamy
Category:Monolingualism	Category:Linguistics	Monolingualism
Category:Monologues	Category:Drama	Monologue
Category:Months	Category:Chronology	Month
Category:Moon	Category:Earth	Moon
Category:Mormon_studies	Category:Cultural_anthropology Category:Study_of_religion	Mormon_studies
Category:Moscow_International_Business_Center	Category:Business	Moscow_International_Business_Center
Category:Moshavim	Category:Agriculture	Moshav
Category:Motorcycle_training	Category:Training Category:Vocational_education	Motorcycle_training
Category:MSC_Malaysia	Category:Business Category:Technology	MSC_Malaysia
Category:Multiculturalism	Category:Cultures	Multiculturalism
Category:Multi-level_marketing	Category:Business_models Category:Business_opportunities	Multi-level_marketing
Category:Multilingualism	Category:Language_acquisition	Multilingualism
Category:Mummers_Parade	Category:Society	Mummers_Parade
Category:Museologists	Category:Museology	Museology
Category:Museology	Category:Humanities Category:Interdisciplinary_fields	Museology
Category:Muses	Category:Museology	Muse
Category:Museums	Category:Culture Category:Education Category:Entertainment Category:Museology	Museum
Category:Museum_ships	Category:Historic_preservation	Museum_ship
Category:Music	Category:Entertainment Category:Performing_arts	Music
Category:Musical_languages	Category:Languages	Musical_language
Category:Musical_terminology	Category:Terminology	Glossary_of_musical_terminology
Category:Musical_theatre	Category:Drama Category:Performing_arts	Musical_theatre
Category:Music_education	Category:Education	Music_education
Category:Music_history	Category:Cultural_history Category:History	Music_history
Category:Music_technology	Category:Technology	Music_technology
Category:Music_venues	Category:Arts	Music_venue
Category:Muslim_historians	Category:Historians	List_of_Muslim_historians
Category:Mythography	Category:Cultural_anthropology	Mythography
Category:Mythology	Category:Arts Category:Cultural_anthropology Category:Traditions	Mythology
Category:Nanotechnology	Category:Interdisciplinary_fields Category:Technology	Nanotechnology
Category:Narratology	Category:Drama Category:Literature	Narratology
Category:National_academies	Category:Education	National_academy
Category:National_identities	Category:Nationality	National_identity
Category:Nationalism	Category:Political_philosophy	Nationalism
Category:Nationalism_studies	Category:Cultural_anthropology Category:History	Nationalism_studies
Category:Nationality	Category:Political_philosophy Category:Society	Nationality
Category:Nationality_law	Category:Nationality	Nationality_law
Category:National_security	Category:Government Category:Politics	National_security
Category:National_Technological_University	Category:Technology	National_Technological_University
Category:Native_American_studies	Category:Area_studies Category:Ethnic_studies	Native_American_studies
Category:Natural_disasters	Category:Natural_hazards Category:Nature	Natural_disaster
Category:Natural_dyes	Category:Natural_materials	Natural_dye
Category:Natural_Farming	Category:Organic_farming	Natural_Farming
Category:Natural_hazards	Category:Nature	Natural_hazard
Category:Natural_history	Category:Science	Natural_history
Category:Natural_history_museums	Category:Natural_history	List_of_natural_history_museums
Category:Naturalists	Category:Natural_history Category:Scientists	Natural_history
Category:Natural_law	Category:Nature	Natural_law
Category:Natural_materials	Category:Matter Category:Nature	Natural_material
Category:Natural_regions_of_Germany	Category:Vernacular_geography	Natural_regions_of_Germany
Category:Natural_resources	Category:Nature	Natural_resource
Category:Natural_sciences	Category:Nature Category:Science	Natural_science
Category:Natural_scientists	Category:Natural_sciences Category:Scientists	Natural_science
Category:Nature	\N	Nature
Category:Nature_deities	Category:Nature	Nature_deity
Category:Nature_goddesses	Category:Nature_deities	Nature_deity
Category:Nature_gods	Category:Nature_deities	Nature_deity
Category:Navigation	Category:Exploration	Navigation
Category:Negotiation	Category:Law	Negotiation
Category:Net_metering	Category:Energy	Net_metering
Category:Network_theory	Category:Operations_research	Network_theory
Category:Neural_engineering	Category:Interdisciplinary_fields	Neural_engineering
Category:Neurolinguistics	Category:Linguistics	Neurolinguistics
Category:Neurological_disorders	Category:Disability	Neurological_disorder
Category:Neuroscience	Category:Interdisciplinary_fields	Neuroscience
Category:Neurotheology	Category:Study_of_religion	Neurotheology
Category:New_religious_movements	Category:Society	New_religious_movement
Category:Nightclubs	Category:Society	Nightclub
Category:Nightlife	Category:Entertainment	Nightlife
Category:Nobel_Prize	Category:History_of_science Category:Science Category:Technology	Nobel_Prize
Category:No-bid_contracts	Category:Pricing	No-bid_contract
Category:Noble_titles	Category:Politics	Royal_and_noble_ranks
Category:No_frills	Category:Business_models	No_frills
Category:Non-classical_logic	Category:Logic	Non-classical_logic
Category:Non-fiction	Category:Reality	Non-fiction
Category:Nonprofit_technology	Category:Information_technology Category:Society Category:Technology	Non-profit_technology
Category:Non-renewable_resources	Category:Natural_resources	Non-renewable_resource
Category:North_Germanic_languages	Category:Scandinavian_studies	North_Germanic_languages
Category:Nostalgia	Category:History	Nostalgia
Category:Notaries	Category:Jurists	Notary_public
Category:Numerical_analysis	Category:Computational_science	Numerical_analysis
Category:Numismatics	Category:Cultural_history	Numismatics
Category:Nurses	Category:Health	Nurse
Category:Nursing	Category:Health_sciences	Nursing
Category:Nursing_education	Category:Education	Nurse_education
Category:Nursing_informatics	Category:Health_informatics	Health_informatics
Category:Nursing_research	Category:Health	Nursing_research
Category:Nutrition	Category:Food_and_drink Category:Health Category:Medicine	Nutrition
Category:NUTS	Category:Geocodes	Nomenclature_of_Territorial_Units_for_Statistics
Category:Oaths	Category:Language	Oath
Category:Obesity_by_country	Category:Health	Epidemiology_of_obesity
Category:Observational_study	Category:Scientific_method	Observational_study
Category:Obsolete_scientific_theories	Category:History_of_science Category:Scientific_theories	Superseded_scientific_theories
Category:Occupational_diseases	Category:Health	Occupational_disease
Category:Occupational_safety_and_health	Category:Health	Occupational_safety_and_health
Category:Oceans	Category:Earth	Ocean
Category:Office_administration	Category:Business Category:Management	Office_Administration
Category:Office_equipment	Category:Business Category:Equipment	Office_supplies
Category:Office_software	Category:Business Category:Business_software	Office_suite
Category:Offshoring	Category:Globalization	Offshoring
Category:Oilfield_terminology	Category:Terminology	Oilfield_terminology
Category:Old_Right_%28United_States%29	Category:Political_philosophy	Old_Right_%28United_States%29
Category:Oligarchy	Category:Culture Category:Politics	Oligarchy
Category:Ombudsmen	Category:Law	Ombudsman
Category:Online_education	Category:Education Category:Educational_technology	E-learning
Category:Online_law_databases	Category:Law Category:Legal_research	Computer-assisted_legal_research
Category:Onomastics	Category:Linguistics	Onomastics
Category:Ontology	Category:Philosophy_of_science Category:Reality	Ontology
Category:Open_air_museums	Category:History	Open-air_museum
Category:Open_source_intelligence	Category:Business_intelligence	Open_source_intelligence
Category:Opera	Category:Performing_arts	Opera
Category:Operating_system_advocacy	Category:Technology	Operating_system_advocacy
Category:Operations_research	Category:Business	Operations_research
Category:Optometrists	Category:Health	Optometry
Category:Oral_history	Category:Biography Category:Historiography Category:History Category:Language	Oral_history
Category:Oral_hygiene	Category:Hygiene	Oral_hygiene
Category:Oral_literature	Category:Literature	Oral_literature
Category:Oral_tradition	Category:Language Category:Traditions	Oral_tradition
Category:Organic_farming	Category:Agriculture	Organic_farming
Category:Organic_food	Category:Food_and_drink Category:Organic_farming	Organic_food
Category:Organic_gardening	Category:Agriculture	Organic_horticulture
Category:Organizations	Category:Corporate_groups Category:Society	Organization
Category:Orientalism	Category:Cultural_anthropology Category:History	Orientalism
Category:Origami	Category:Arts	Origami
Category:Origin_of_life	Category:Evolution	Abiogenesis
Category:Orthography	Category:Linguistics	Orthography
Category:Osteopathic_medicine	Category:Medicine	Osteopathy
Category:Outdoor_education	Category:Alternative_education	Outdoor_education
Category:Outward_Bound	Category:Education	Outward_Bound
Category:Packaging	Category:Technology	Packaging_and_labeling
Category:Packaging_materials	Category:Packaging	Packaging_and_labeling
Category:Pagers	Category:Mobile_technology	Pager
Category:Pakistani_society	Category:Society	Culture_of_Pakistan
Category:Palaeography	Category:Philology	Palaeography
Category:Paleontology	Category:Chronology	Paleontology
Category:Pan_movements	Category:Culture	Pan-nationalism
Category:Pantomime	Category:Comedy	Pantomime
Category:Papal_encyclicals	Category:Historical_documents	Encyclical
Category:Paper_folding	Category:Arts	Origami
Category:Papermaking	Category:Arts	Papermaking
Category:Paramedics	Category:Health	Paramedic
Category:Parent_education_program	Category:Educational_psychology	Parent_education_program
Category:Parenting	Category:Family	Parenting
Category:Parks	Category:Agriculture	Park
Category:Parliamentary_committees	Category:Political_communication Category:Political_organizations	Committee
Category:Parole	Category:Legal_terms	Parole
Category:Parties	Category:Traditions	Party
Category:Parting_traditions	Category:Traditions	Parting_tradition
Category:Partnerships	Category:Law	Partnership
Category:Pastoralists	Category:Agriculture	Pastoralism
Category:Patient_safety	Category:Medicine	Patient_safety
Category:Patronymics	Category:Society	Patronymic
Category:Peace	Category:Political_philosophy Category:Politics Category:Society	Peace
Category:Peace_education	Category:Education	Peace_education
Category:Pedagogy	Category:Education_theory Category:Teaching	Pedagogy
Category:Pediatrics	Category:Health	Pediatrics
Category:Peer_review	Category:Scientific_method	Peer_review
Category:Penology	Category:Crime	Penology
Category:Penske	Category:Business	Penske_Corporation
Category:People	Category:Society	People
Category:People_with_disabilities	Category:Disability	Disability
Category:Performance_art	Category:Performing_arts	Performance_art
Category:Performance_management	Category:Management	Performance_management
Category:Performances	Category:Arts	Performance
Category:Performing_arts	Category:Arts Category:Entertainment	Performing_arts
Category:Performing_arts_education	Category:Culture Category:Education Category:Performing_arts	Performing_arts_education
Category:Performing_arts_presenters	Category:Performing_arts	Performing_arts_presenters
Category:Permaculture	Category:Agriculture	Permaculture
Category:Perpetual_motion	Category:Science	Perpetual_motion
Category:Personal_computing	Category:Home	Personal_computer
Category:Personal_selling	Category:Business Category:Sales	Sales
Category:Personifications_of_death	Category:Culture	Death_%28personification%29
Category:Pesticides	Category:Agricultural_chemicals Category:Industrial_agriculture	Pesticide
Category:Peter_Cooper	Category:Business	Peter_Cooper
Category:Petroleum_politics	Category:Politics	Petroleum_politics
Category:Pets	Category:Domesticated_animals Category:Entertainment	Pet
Category:Pharmaceutical_sciences	Category:Health_sciences Category:Interdisciplinary_fields	Pharmaceutical_sciences
Category:Pharmaceuticals_policy	Category:Healthcare Category:Health_policy	Pharmaceutical_policy
Category:Pharmacists	Category:Health	Pharmacist
Category:Pharmacy_education	Category:Health_education	Pharmacy_school
Category:Phases_of_matter	Category:Matter	Phase_%28matter%29
Category:Phenomena	Category:Nature	Phenomenon
Category:Philately	Category:Cultural_history	Philately
Category:Philippine_society	Category:Society	Culture_of_the_Philippines
Category:Philologists	Category:Philology	Philology
Category:Philology	Category:History Category:Language Category:Linguistics	Philology
Category:Philosophers	Category:Philosophy	Philosophy
Category:Philosophers_of_education	Category:Philosophy_of_education	Philosophy_of_education
Category:Philosophers_of_science	Category:Philosophy_of_science	Philosophy_of_science
Category:Philosophical_theories	Category:Philosophy	Philosophical_theory
Category:Philosophy	Category:Humanities	Philosophy
Category:Philosophy_of_biology	Category:Philosophy_of_science	Philosophy_of_biology
Category:Philosophy_of_computer_science	Category:Philosophy_of_science	Philosophy_of_computer_science
Category:Philosophy_of_education	Category:Education	Philosophy_of_education
Category:Philosophy_of_history	Category:History	Philosophy_of_history
Category:Philosophy_of_language	Category:Language Category:Linguistics	Philosophy_of_language
Category:Philosophy_of_law	Category:Law Category:Political_philosophy	Jurisprudence
Category:Philosophy_of_music	Category:Aesthetics	Philosophy_of_music
Category:Philosophy_of_physics	Category:Philosophy_of_science	Philosophy_of_physics
Category:Philosophy_of_religion	Category:Religion	Philosophy_of_religion
Category:Philosophy_of_science	Category:Culture Category:Science Category:Science_studies	Philosophy_of_science
Category:Philosophy_of_sexuality	Category:Society	Philosophy_of_sex
Category:Philosophy_of_time	Category:Philosophy_of_science	Philosophy_of_space_and_time
Category:Phonaesthetics	Category:Aesthetics Category:Philosophy_of_language	Phonaesthetics
Category:Phonetics	Category:Linguistics	Phonetics
Category:Phonology	Category:Language Category:Linguistics	Phonology
Category:Photography	Category:Arts	Photography
Category:Phylogenetics	Category:Scientific_classification	Phylogenetics
Category:Physical_geography	Category:Geography	Physical_geography
Category:Physical_objects	Category:Matter	Physical_body
Category:Physical_phenomena	Category:Matter Category:Phenomena	Phenomenon
Category:Physical_sciences	Category:Natural_sciences Category:Science	Outline_of_physical_science
Category:Physical_systems	Category:Systems	Physical_system
Category:Physical_theatre	Category:Performing_arts	Physical_theatre
Category:Physicians	Category:Health Category:Medicine	Physician
Category:Physics_education	Category:Education	Physics_education
Category:Physiognomy	Category:History_of_science	Physiognomy
Category:Physiological_plant_disorders	Category:Agriculture	Physiological_plant_disorders
Category:Pie_throwing	Category:Comedy	Pieing
Category:Pig_farming	Category:Agriculture	Pig_farming
Category:Place_names	Category:Geography	Toponymy
Category:Planning	Category:Management	Planning
Category:Plantations	Category:Agriculture	Plantation
Category:Plants	Category:Agriculture	Plant
Category:Plot_%28narrative%29	Category:Drama	Plot_%28narrative%29
Category:Police_divisions	Category:Law_enforcement	Police_division
Category:Police_misconduct	Category:Law_enforcement	Police_misconduct
Category:Police_strikes	Category:Law_enforcement	Police_strikes
Category:Policy	Category:Government	Policy
Category:Polish_society	Category:Society	Demographics_of_Poland
Category:Political_activism	Category:Politics	Activism
Category:Political_alliance	Category:Politics	Political_coalition
Category:Political_campaigns	Category:Political_activism	Political_campaign
Category:Political_catch_phrases	Category:Political_communication	List_of_political_catch_phrases
Category:Political_communication	Category:Communication Category:Politics	Political_communication
Category:Political_correctness	Category:Political_communication Category:Politics	Political_correctness
Category:Political_corruption	Category:Politics	Political_corruption
Category:Political_crimes	Category:Politics	Political_crime
Category:Political_families	Category:Politics	Political_family
Category:Political_geography	Category:Business Category:Human_geography	Political_geography
Category:Political_history	Category:History	Political_history
Category:Political_movements	Category:Political_activism Category:Political_philosophy	Political_movement
Category:Political_organizations	Category:Politics	Political_organisation
Category:Political_parties	Category:Corporate_groups Category:Political_organizations	List_of_political_parties
Category:Political_philosophers	Category:Political_philosophy	List_of_political_philosophers
Category:Political_philosophy	Category:Politics	Political_philosophy
Category:Political_realism	Category:Political_philosophy	Realism_%28international_relations%29
Category:Political_satire	Category:Political_communication Category:Political_philosophy	Political_satire
Category:Political_science	Category:Interdisciplinary_fields Category:Political_philosophy Category:Politics Category:Social_sciences	Political_science
Category:Political_scientists	Category:Political_science	List_of_political_scientists
Category:Political_spectrum	Category:Politics	Political_spectrum
Category:Political_systems	Category:Political_philosophy	Political_system
Category:Politics	Category:Society Category:Sociology	Politics
Category:Politics_of_Abkhazia	Category:Politics	Politics_of_Abkhazia
Category:Politics_of_Afghanistan	Category:Politics	Politics_of_Afghanistan
Category:Politics_of_Albania	Category:Politics	Politics_of_Albania
Category:Politics_of_Algeria	Category:Politics	Politics_of_Algeria
Category:Politics_of_American_Samoa	Category:Politics	Politics_of_American_Samoa
Category:Politics_of_Andorra	Category:Politics	Politics_of_Andorra
Category:Politics_of_Angola	Category:Politics	Politics_of_Angola
Category:Politics_of_Anguilla	Category:Politics	Politics_of_Anguilla
Category:Politics_of_Antigua_and_Barbuda	Category:Politics	Politics_of_Antigua_and_Barbuda
Category:Politics_of_Argentina	Category:Politics	Politics_of_Argentina
Category:Politics_of_Armenia	Category:Politics	Politics_of_Armenia
Category:Politics_of_Aruba	Category:Politics	Politics_of_Aruba
Category:Politics_of_Australia	Category:Politics	Politics_of_Australia
Category:Politics_of_Austria	Category:Politics	Politics_of_Austria
Category:Politics_of_Azerbaijan	Category:Politics	Politics_of_Azerbaijan
Category:Politics_of_Bahrain	Category:Politics	Politics_of_Bahrain
Category:Politics_of_Bangladesh	Category:Politics	Politics_of_Bangladesh
Category:Politics_of_Barbados	Category:Politics	Politics_of_Barbados
Category:Politics_of_Belarus	Category:Politics	Politics_of_Belarus
Category:Politics_of_Belgium	Category:Politics	Politics_of_Belgium
Category:Politics_of_Belize	Category:Politics	Politics_of_Belize
Category:Politics_of_Benin	Category:Politics	Politics_of_Benin
Category:Politics_of_Bermuda	Category:Politics	Politics_of_Bermuda
Category:Politics_of_Bhutan	Category:Politics	Politics_of_Bhutan
Category:Politics_of_Bolivia	Category:Politics	Politics_of_Bolivia
Category:Politics_of_Bosnia_and_Herzegovina	Category:Politics	Politics_of_Bosnia_and_Herzegovina
Category:Politics_of_Botswana	Category:Politics	Politics_of_Botswana
Category:Politics_of_Brazil	Category:Politics	Politics_of_Brazil
Category:Politics_of_Brunei	Category:Politics	Politics_of_Brunei
Category:Politics_of_Bulgaria	Category:Politics	Politics_of_Bulgaria
Category:Politics_of_Burkina_Faso	Category:Politics	Politics_of_Burkina_Faso
Category:Politics_of_Burundi	Category:Politics	Politics_of_Burundi
Category:Politics_of_Cambodia	Category:Politics	Politics_of_Cambodia
Category:Politics_of_Cameroon	Category:Politics	Politics_of_Cameroon
Category:Politics_of_Canada	Category:Politics	Politics_of_Canada
Category:Politics_of_Cape_Verde	Category:Politics	Politics_of_Cape_Verde
Category:Politics_of_C%C3%B4te_d%27Ivoire	Category:Politics	Politics_of_C%C3%B4te_d%27Ivoire
Category:Politics_of_Chad	Category:Politics	Politics_of_Chad
Category:Politics_of_Chile	Category:Politics	Politics_of_Chile
Category:Politics_of_Colombia	Category:Politics	Politics_of_Colombia
Category:Politics_of_Comoros	Category:Politics	Politics_of_the_Comoros
Category:Politics_of_Costa_Rica	Category:Politics	Politics_of_Costa_Rica
Category:Politics_of_country_subdivisions	Category:Politics	Politics_of_country_subdivisions
Category:Politics_of_Croatia	Category:Politics	Politics_of_Croatia
Category:Politics_of_Cuba	Category:Politics	Politics_of_Cuba
Category:Politics_of_Cura%C3%A7ao	Category:Politics	Politics_of_Cura%C3%A7ao
Category:Politics_of_Cyprus	Category:Politics	Politics_of_Cyprus
Category:Politics_of_Denmark	Category:Politics	Politics_of_Denmark
Category:Politics_of_Djibouti	Category:Politics	Politics_of_Djibouti
Category:Politics_of_Dominica	Category:Politics	Politics_of_Dominica
Category:Politics_of_East_Timor	Category:Politics	Politics_of_East_Timor
Category:Politics_of_Ecuador	Category:Politics	Politics_of_Ecuador
Category:Politics_of_El_Salvador	Category:Politics	Politics_of_El_Salvador
Category:Politics_of_England	Category:Politics_of_country_subdivisions	Politics_of_England
Category:Politics_of_Eritrea	Category:Politics	Politics_of_Eritrea
Category:Politics_of_Estonia	Category:Politics	Politics_of_Estonia
Category:Politics_of_Ethiopia	Category:Politics	Politics_of_Ethiopia
Category:Politics_of_Fiji	Category:Politics	Politics_of_Fiji
Category:Politics_of_Finland	Category:Politics	Politics_of_Finland
Category:Politics_of_France	Category:Politics	Politics_of_France
Category:Politics_of_French_Polynesia	Category:Politics	Politics_of_French_Polynesia
Category:Politics_of_Gabon	Category:Politics	Politics_of_Gabon
Category:Politics_of_Georgia_%28country%29	Category:Politics	Politics_of_Georgia_%28country%29
Category:Politics_of_Germany	Category:Politics	Politics_of_Germany
Category:Politics_of_Ghana	Category:Politics	Politics_of_Ghana
Category:Politics_of_Gibraltar	Category:Politics	Politics_of_Gibraltar
Category:Politics_of_Greece	Category:Politics	Politics_of_Greece
Category:Politics_of_Greenland	Category:Politics	Politics_of_Greenland
Category:Politics_of_Grenada	Category:Politics	Politics_of_Grenada
Category:Politics_of_Guam	Category:Politics	Politics_of_Guam
Category:Politics_of_Guatemala	Category:Politics	Politics_of_Guatemala
Category:Politics_of_Guinea-Bissau	Category:Politics	Politics_of_Guinea-Bissau
Category:Politics_of_Guyana	Category:Politics	Politics_of_Guyana
Category:Politics_of_Haiti	Category:Politics	Politics_of_Haiti
Category:Politics_of_Honduras	Category:Politics	Politics_of_Honduras
Category:Politics_of_Hungary	Category:Politics	Politics_of_Hungary
Category:Politics_of_Iceland	Category:Politics	Politics_of_Iceland
Category:Politics_of_India	Category:Politics	Politics_of_India
Category:Politics_of_Indonesia	Category:Politics	Politics_of_Indonesia
Category:Politics_of_Iran	Category:Politics	Politics_of_Iran
Category:Politics_of_Iraq	Category:Politics	Politics_of_Iraq
Category:Politics_of_Israel	Category:Politics	Politics_of_Israel
Category:Politics_of_Italy	Category:Politics	Politics_of_Italy
Category:Politics_of_Jamaica	Category:Politics	Politics_of_Jamaica
Category:Politics_of_Japan	Category:Politics	Politics_of_Japan
Category:Politics_of_Jersey	Category:Politics	Politics_of_Jersey
Category:Politics_of_Jordan	Category:Politics	Politics_of_Jordan
Category:Politics_of_Kazakhstan	Category:Politics	Politics_of_Kazakhstan
Category:Politics_of_Kenya	Category:Politics	Politics_of_Kenya
Category:Politics_of_Kiribati	Category:Politics	Politics_of_Kiribati
Category:Politics_of_Kosovo	Category:Politics	Politics_of_Kosovo
Category:Politics_of_Kyrgyzstan	Category:Politics	Politics_of_Kyrgyzstan
Category:Politics_of_Laos	Category:Politics	Politics_of_Laos
Category:Politics_of_Latvia	Category:Politics	Politics_of_Latvia
Category:Politics_of_Lebanon	Category:Politics	Politics_of_Lebanon
Category:Politics_of_Lesotho	Category:Politics	Politics_of_Lesotho
Category:Politics_of_Liberia	Category:Politics	Politics_of_Liberia
Category:Politics_of_Libya	Category:Politics	Politics_of_Libya
Category:Politics_of_Liechtenstein	Category:Politics	Politics_of_Liechtenstein
Category:Politics_of_Lithuania	Category:Politics	Politics_of_Lithuania
Category:Politics_of_Luxembourg	Category:Politics	Politics_of_Luxembourg
Category:Politics_of_Madagascar	Category:Politics	Politics_of_Madagascar
Category:Politics_of_Malawi	Category:Politics	Politics_of_Malawi
Category:Politics_of_Malaysia	Category:Politics	Politics_of_Malaysia
Category:Politics_of_Mali	Category:Politics	Politics_of_Mali
Category:Politics_of_Malta	Category:Politics	Politics_of_Malta
Category:Politics_of_Mauritania	Category:Politics	Politics_of_Mauritania
Category:Politics_of_Mauritius	Category:Politics	Politics_of_Mauritius
Category:Politics_of_Mayotte	Category:Politics	Politics_of_Mayotte
Category:Politics_of_Mexico	Category:Politics	Politics_of_Mexico
Category:Politics_of_Moldova	Category:Politics	Politics_of_Moldova
Category:Politics_of_Monaco	Category:Politics	Politics_of_Monaco
Category:Politics_of_Mongolia	Category:Politics	Politics_of_Mongolia
Category:Politics_of_Montenegro	Category:Politics	Politics_of_Montenegro
Category:Politics_of_Montserrat	Category:Politics	Politics_of_Montserrat
Category:Politics_of_Morocco	Category:Politics	Politics_of_Morocco
Category:Politics_of_Mozambique	Category:Politics	Politics_of_Mozambique
Category:Politics_of_Nagorno-Karabakh	Category:Politics	Politics_of_Nagorno-Karabakh
Category:Politics_of_Namibia	Category:Politics	Politics_of_Namibia
Category:Politics_of_Nauru	Category:Politics	Politics_of_Nauru
Category:Politics_of_Nepal	Category:Politics	Politics_of_Nepal
Category:Politics_of_New_Caledonia	Category:Politics	Politics_of_New_Caledonia
Category:Politics_of_New_Zealand	Category:Politics	Politics_of_New_Zealand
Category:Politics_of_Nicaragua	Category:Politics	Politics_of_Nicaragua
Category:Politics_of_Niger	Category:Politics	Politics_of_Niger
Category:Politics_of_Nigeria	Category:Politics	Politics_of_Nigeria
Category:Politics_of_Niue	Category:Politics	Politics_of_Niue
Category:Politics_of_Norfolk_Island	Category:Politics	Politics_of_Norfolk_Island
Category:Politics_of_Norway	Category:Politics	Politics_of_Norway
Category:Politics_of_Oman	Category:Politics	Politics_of_Oman
Category:Politics_of_Pakistan	Category:Politics	Politics_of_Pakistan
Category:Politics_of_Palau	Category:Politics	Politics_of_Palau
Category:Politics_of_Panama	Category:Politics	Politics_of_Panama
Category:Politics_of_Papua_New_Guinea	Category:Politics	Politics_of_Papua_New_Guinea
Category:Politics_of_Paraguay	Category:Politics	Politics_of_Paraguay
Category:Politics_of_Peru	Category:Politics	Politics_of_Peru
Category:Politics_of_Poland	Category:Politics	Politics_of_Poland
Category:Politics_of_Portugal	Category:Politics	Politics_of_Portugal
Category:Politics_of_Puerto_Rico	Category:Politics	Politics_of_Puerto_Rico
Category:Politics_of_Romania	Category:Politics	Politics_of_Romania
Category:Politics_of_Russia	Category:Politics	Politics_of_Russia
Category:Politics_of_Rwanda	Category:Politics	Politics_of_Rwanda
Category:Politics_of_Saint_Helena	Category:Politics	Politics_of_Saint_Helena
Category:Politics_of_Saint_Kitts_and_Nevis	Category:Politics	Politics_of_Saint_Kitts_and_Nevis
Category:Politics_of_Saint_Lucia	Category:Politics	Politics_of_Saint_Lucia
Category:Politics_of_Saint_Vincent_and_the_Grenadines	Category:Politics	Politics_of_Saint_Vincent_and_the_Grenadines
Category:Politics_of_Samoa	Category:Politics	Politics_of_Samoa
Category:Politics_of_San_Marino	Category:Politics	Politics_of_San_Marino
Category:Politics_of_Saudi_Arabia	Category:Politics	Politics_of_Saudi_Arabia
Category:Politics_of_S%C3%A3o_Tom%C3%A9_and_Pr%C3%ADncipe	Category:Politics	Politics_of_S%C3%A3o_Tom%C3%A9_and_Pr%C3%ADncipe
Category:Politics_of_science	Category:History_of_science Category:Politics Category:Science Category:Society	Politicization_of_science
Category:Politics_of_Scotland	Category:Politics	Politics_of_Scotland
Category:Politics_of_Senegal	Category:Politics	Politics_of_Senegal
Category:Politics_of_Serbia	Category:Politics	Politics_of_Serbia
Category:Politics_of_Seychelles	Category:Politics	Politics_of_Seychelles
Category:Politics_of_Sierra_Leone	Category:Politics	Politics_of_Sierra_Leone
Category:Politics_of_Singapore	Category:Politics	Politics_of_Singapore
Category:Politics_of_Sint_Maarten	Category:Politics	Politics_of_Sint_Maarten
Category:Politics_of_Slovakia	Category:Politics	Politics_of_Slovakia
Category:Politics_of_Slovenia	Category:Politics	Politics_of_Slovenia
Category:Politics_of_Somalia	Category:Politics	Politics_of_Somalia
Category:Politics_of_South_Africa	Category:Politics	Politics_of_South_Africa
Category:Politics_of_Spain	Category:Politics	Politics_of_Spain
Category:Politics_of_Sri_Lanka	Category:Politics	Politics_of_Sri_Lanka
Category:Politics_of_Sudan	Category:Politics	Politics_of_Sudan
Category:Politics_of_Suriname	Category:Politics	Politics_of_Suriname
Category:Politics_of_Swaziland	Category:Politics	Politics_of_Swaziland
Category:Politics_of_Sweden	Category:Politics	Politics_of_Sweden
Category:Politics_of_Switzerland	Category:Politics	Politics_of_Switzerland
Category:Politics_of_Syria	Category:Politics	Politics_of_Syria
Category:Politics_of_Tanzania	Category:Politics	Politics_of_Tanzania
Category:Politics_of_Thailand	Category:Politics	Politics_of_Thailand
Category:Politics_of_the_Bahamas	Category:Politics	Politics_of_the_Bahamas
Category:Politics_of_the_British_Virgin_Islands	Category:Politics	Politics_of_the_British_Virgin_Islands
Category:Politics_of_the_Cayman_Islands	Category:Politics	Politics_of_the_Cayman_Islands
Category:Politics_of_the_Central_African_Republic	Category:Politics	Politics_of_the_Central_African_Republic
Category:Politics_of_the_Collectivity_of_Saint_Martin	Category:Politics	Politics_of_the_Collectivity_of_Saint_Martin
Category:Politics_of_the_Cook_Islands	Category:Politics	Politics_of_the_Cook_Islands
Category:Politics_of_the_Czech_Republic	Category:Politics	Politics_of_the_Czech_Republic
Category:Politics_of_the_Democratic_Republic_of_the_Congo	Category:Politics	Politics_of_the_Democratic_Republic_of_the_Congo
Category:Politics_of_the_Dominican_Republic	Category:Politics	Politics_of_the_Dominican_Republic
Category:Politics_of_the_Falkland_Islands	Category:Politics	Politics_of_the_Falkland_Islands
Category:Politics_of_the_Faroe_Islands	Category:Politics	Politics_of_the_Faroe_Islands
Category:Politics_of_the_Federated_States_of_Micronesia	Category:Politics	Politics_of_the_Federated_States_of_Micronesia
Category:Politics_of_the_Gambia	Category:Politics	Politics_of_the_Gambia
Category:Politics_of_the_Isle_of_Man	Category:Politics	Politics_of_the_Isle_of_Man
Category:Politics_of_the_Maldives	Category:Politics	Politics_of_the_Maldives
Category:Politics_of_the_Marshall_Islands	Category:Politics	Politics_of_the_Marshall_Islands
Category:Politics_of_the_Netherlands	Category:Politics	Politics_of_the_Netherlands
Category:Politics_of_the_Netherlands_Antilles	Category:Politics	Politics_of_the_Netherlands_Antilles
Category:Politics_of_the_People%27s_Republic_of_China	Category:Politics	Politics_of_the_People%27s_Republic_of_China
Category:Politics_of_the_Philippines	Category:Politics	Politics_of_the_Philippines
Category:Politics_of_the_Pitcairn_Islands	Category:Politics	Politics_of_the_Pitcairn_Islands
Category:Politics_of_the_Republic_of_China	Category:Politics	Politics_of_the_Republic_of_China
Category:Politics_of_the_Republic_of_Ireland	Category:Politics	Politics_of_the_Republic_of_Ireland
Category:Politics_of_the_Republic_of_Macedonia	Category:Politics	Politics_of_the_Republic_of_Macedonia
Category:Politics_of_the_Republic_of_the_Congo	Category:Politics	Politics_of_the_Republic_of_the_Congo
Category:Politics_of_the_Sahrawi_Arab_Democratic_Republic	Category:Politics	Politics_of_the_Sahrawi_Arab_Democratic_Republic
Category:Politics_of_the_Solomon_Islands	Category:Politics	Politics_of_the_Solomon_Islands
Category:Politics_of_the_Turks_and_Caicos_Islands	Category:Politics	Politics_of_the_Turks_and_Caicos_Islands
Category:Politics_of_the_United_Arab_Emirates	Category:Politics	Politics_of_the_United_Arab_Emirates
Category:Politics_of_the_United_Kingdom	Category:Politics	Politics_of_the_United_Kingdom
Category:Politics_of_the_United_States	Category:Politics	Politics_of_the_United_States
Category:Politics_of_Tibet	Category:Politics	Politics_in_Tibet
Category:Politics_of_Togo	Category:Politics	Politics_of_Togo
Category:Politics_of_Tokelau	Category:Politics	Politics_of_Tokelau
Category:Politics_of_Trinidad_and_Tobago	Category:Politics	Politics_of_Trinidad_and_Tobago
Category:Politics_of_Tunisia	Category:Politics	Politics_of_Tunisia
Category:Politics_of_Turkey	Category:Politics	Politics_of_Turkey
Category:Politics_of_Turkmenistan	Category:Politics	Politics_of_Turkmenistan
Category:Politics_of_Tuvalu	Category:Politics	Politics_of_Tuvalu
Category:Politics_of_Uganda	Category:Politics	Politics_of_Uganda
Category:Politics_of_Ukraine	Category:Politics	Politics_of_Ukraine
Category:Politics_of_Uruguay	Category:Politics	Politics_of_Uruguay
Category:Politics_of_Uzbekistan	Category:Politics	Politics_of_Uzbekistan
Category:Politics_of_Vanuatu	Category:Politics	Politics_of_Vanuatu
Category:Politics_of_Vatican_City	Category:Politics	Politics_of_Vatican_City
Category:Politics_of_Venezuela	Category:Politics	Politics_of_Venezuela
Category:Politics_of_Vietnam	Category:Politics	Politics_of_Vietnam
Category:Politics_of_Wales	Category:Politics_of_country_subdivisions	Politics_of_Wales
Category:Politics_of_Wallis_and_Futuna	Category:Politics	Politics_of_Wallis_and_Futuna
Category:Politics_of_Western_Sahara	Category:Politics	Politics_of_Western_Sahara
Category:Politics_of_Yemen	Category:Politics	Politics_of_Yemen
Category:Politics_of_Yugoslavia	Category:Politics	Socialist_Federal_Republic_of_Yugoslavia
Category:Politics_of_Zambia	Category:Politics	Politics_of_Zambia
Category:Politology	Category:Political_science	Political_science
Category:Pollution	Category:Business Category:Technology	Pollution
Category:Polygamy	Category:Mating_systems	Polygamy
Category:Popes	Category:Politics	List_of_popes
Category:Popular_culture	Category:Cultural_history Category:Cultures	Popular_culture
Category:Popular_education	Category:Alternative_education Category:History_of_education	Popular_education
Category:Populated_places	Category:Geography	Populated_place
Category:Population	Category:Human_geography	Population
Category:Populism	Category:Political_philosophy Category:Rhetoric	Populism
Category:Pornography	Category:Entertainment	Pornography
Category:Positivism	Category:Philosophy_of_science Category:Political_philosophy	Positivism
Category:Postcolonialism	Category:Political_philosophy	Postcolonialism
Category:Postmodern_religion	Category:Religion	Postmodern_religion
Category:Pottery	Category:Arts	Pottery
Category:Poultry_farming	Category:Agriculture	Poultry_farming
Category:Poverty	Category:Socioeconomics	Poverty
Category:Poverty_by_country	Category:Society	List_of_countries_by_percentage_of_population_living_in_poverty
Category:Power_%28physics%29	Category:Energy	Power_%28physics%29
Category:Power_tools	Category:Tools	Power_tool
Category:Practice_of_law	Category:Law	Practice_of_law
Category:Pragmatics	Category:Linguistics	Pragmatics
Category:Prague_Linguistic_Circle	Category:Linguistics	Prague_Linguistic_Circle
Category:Prank_calling	Category:Comedy	Prank_call
Category:Prejudices	Category:Sociology	Prejudice
Category:Prequels	Category:Entertainment	Prequel
Category:Preservation_%28library_and_archival_science%29	Category:Museology	Preservation_%28library_and_archival_science%29
Category:Presidents	Category:Politics	President
Category:Pricing	Category:Business Category:Marketing	Pricing
Category:Priestly_caste	Category:Religion	Priestly_caste
Category:Primary_care	Category:Healthcare	Primary_care
Category:Primary_sources	Category:Historiography	Primary_source
Category:Prison_sexuality	Category:Society	Prison_sexuality
Category:Privacy_law	Category:Law	Privacy_law
Category:Private_police	Category:Law_enforcement	Private_police
Category:Privileged_communication	Category:Law	Privilege_%28evidence%29
Category:Probability_and_statistics	Category:Inductive_reasoning	Probability_and_statistics
Category:Process_theology	Category:Process_theory	Process_theology
Category:Process_theory	Category:Science	Process_theory
Category:Pro-choice_movement	Category:Health	Abortion-rights_movement
Category:Procurement	Category:Business	Procurement
Category:Profanity	Category:Vocabulary	Profanity
Category:Professional_accountancy_bodies	Category:Accountancy	Professional_accounting_body
Category:Professorships	Category:Education	Professor
Category:Progressive_education	Category:Alternative_education Category:Philosophy_of_education	Progressive_education
Category:Progressivism	Category:Political_philosophy	Progressivism
Category:Project_management	Category:Management	Project_management
Category:Project_management_software	Category:Business_software	Project_management_software
Category:Pro-life_movement	Category:Health	Pro-life_movement
Category:Propaganda	Category:Political_communication	Propaganda
Category:Propagandists	Category:Politics	Propaganda
Category:Property_law	Category:Common_law	Property_law
Category:Property_management	Category:Management	Property_management
Category:Prosecution	Category:Law_enforcement	Prosecutor
Category:Prostitution_by_country	Category:Society	Prostitution_by_country
Category:Protected_areas	Category:Geography Category:Human_geography	Protected_area
Category:Protests	Category:Society	Protest
Category:Proto-languages	Category:Languages	Proto-language
Category:Psephology	Category:Elections	Psephology
Category:Pseudepigraphy	Category:Writing	Pseudepigraph
Category:Pseudoarchaeology	Category:Archaeology	Pseudoarchaeology
Category:Pseudohistory	Category:Historiography	Pseudohistory
Category:Pseudo-scholarship	Category:Education	Pseudo-scholarship
Category:Pseudoscience	Category:Science	Pseudoscience
Category:Psychiatrists	Category:Health	Psychiatrist
Category:Psychogeography	Category:Human_geography	Psychogeography
Category:Psycholinguistics	Category:Linguistics	Psycholinguistics
Category:Psychological_theories	Category:Scientific_theories	Psychology
Category:Psychology	Category:Science Category:Social_sciences	Psychology
Category:Psychology_of_religion	Category:Religion	Psychology_of_religion
Category:Psychometrics	Category:Education Category:Educational_psychology	Psychometrics
Category:Psychotherapists	Category:Health	Psychotherapy
Category:Public_administration	Category:Business Category:Civil_society	Public_administration
Category:Public_archaeology	Category:Archaeology	Community_archaeology
Category:Public_art	Category:Government	Public_art
Category:Public_economics	Category:Government	Public_economics
Category:Public_health	Category:Health Category:Health_economics Category:Health_policy	Public_health
Category:Public_law	Category:Government Category:Law	Public_law
Category:Publicly_funded_health_care	Category:Healthcare Category:Health_economics Category:Health_policy	Publicly_funded_health_care
Category:Public_opinion	Category:Cultural_trends Category:Political_science	Public_opinion
Category:Public_policy	Category:Government	Public_policy
Category:Public_policy_schools	Category:Political_organizations	Public_policy_school
Category:Public_records	Category:Business Category:Government	Public_records
Category:Public_relations	Category:Business	Public_relations
Category:Public_services	Category:Social_institutions	Public_services
Category:Public_speaking	Category:Language	Public_speaking
Category:Publishing_software	Category:Business_software	Desktop_publishing
Category:Punctuation	Category:Language	Punctuation
Category:Qualitative_research	Category:Scientific_method	Qualitative_research
Category:Quantitative_linguistics	Category:Linguistics	Quantitative_linguistics
Category:Quantitative_research	Category:Scientific_method	Quantitative_research
Category:Queen%27s_Awards_for_Enterprise	Category:Business	Queen%27s_Awards_for_Enterprise
Category:Queensland_University_of_Technology	Category:Technology	Queensland_University_of_Technology
Category:Queer_theory	Category:Gender_studies	Queer_theory
Category:Questioned_document_examination	Category:Science	Questioned_document_examination
Category:Queueing_theory	Category:Operations_research	Queueing_theory
Category:Quotations	Category:Language	Quotation
Category:Race_and_health	Category:Ethnicity Category:Health	Race_and_health
Category:Radar	Category:Wireless	Radar
Category:Radicalism_%28historical%29	Category:Political_philosophy	Radicalism_%28historical%29
Category:Radio	Category:Language Category:Wireless	Radio
Category:Radioactive_quackery	Category:Health	Radioactive_quackery
Category:Radio_paging	Category:Mobile_technology	Pager
Category:Radio_technology	Category:Technology	Radio
Category:Rammed_earth	Category:Natural_materials	Rammed_earth
Category:Ranchers	Category:Agriculture	Ranch
Category:Ranches	Category:Agriculture	Ranch
Category:Rare_diseases	Category:Health	Rare_disease
Category:Rayguns	Category:Fictional_technology	Raygun
Category:Realism	Category:Reality	Realism
Category:Reality	Category:Nature	Reality
Category:Reasoning	Category:Logic	Reason
Category:Rebellion	Category:Political_activism	Rebellion
Category:Recall_elections	Category:Elections	Recall_election
Category:Recorders	Category:Equipment Category:Technology_systems	Recorder
Category:Recursion	Category:Self-reference	Recursion
Category:Reference_works	Category:Education	Reference_work
Category:Referendums	Category:Elections	Referendum
Category:Regional_geography	Category:Geography	Regional_geography
Category:Regional_science	Category:Interdisciplinary_fields Category:Social_sciences	Regional_science
Category:Regions	Category:Geography	Region
Category:Religion	Category:Cultural_anthropology Category:Culture Category:Social_institutions	Religion
Category:Religion_and_children	Category:Society	Religion_and_children
Category:Religion_and_politics	Category:Politics Category:Society	Political_science_of_religion
Category:Religion_and_science	Category:Culture Category:Society	Relationship_between_religion_and_science
Category:Religion_and_violence	Category:Society	Religious_violence
Category:Religion_by_country	Category:Society	Religions_by_country
Category:Religious_antisemitism	Category:Society	Religious_antisemitism
Category:Religious_discrimination	Category:Society	Religious_discrimination
Category:Religious_education	Category:Education Category:Society	Religious_education
Category:Religious_ethics	Category:Society	Ethics_in_religion
Category:Religious_identity	Category:Religion	Religion
Category:Religious_law	Category:Law Category:Society	Religious_law
Category:Religious_music	Category:Arts	Religious_music
Category:Religious_nationalism	Category:Society	Religious_nationalism
Category:Religious_naturalism	Category:Nature	Religious_naturalism
Category:Religious_organizations	Category:Society	Religious_denomination
Category:Religious_persecution	Category:Society	Religious_persecution
Category:Religious_philosophy	Category:Philosophy	Religious_philosophy
Category:Religious_pluralism	Category:Society	Religious_pluralism
Category:Religious_riots	Category:Society	Religious_violence
Category:Remote_control	Category:Wireless	Remote_control
Category:Remote_sensing	Category:Geography	Remote_sensing
Category:Renaissance_humanism	Category:Education	Renaissance_humanism
Category:Renewable_resources	Category:Natural_resources	Renewable_resource
Category:Rensselaer_Polytechnic_Institute	Category:Technology	Rensselaer_Polytechnic_Institute
Category:Reproductive_rights	Category:Society	Reproductive_rights
Category:Research	Category:Education Category:Learning Category:Scientific_method	Research
Category:Research_and_development	Category:Business	Research_and_development
Category:Research_methods	Category:Scientific_method	Research
Category:Reservoirs	Category:Irrigation	Reservoir
Category:Residency	Category:Nationality	Residency
Category:Resource_economics	Category:Economics	Natural_resource_economics
Category:Resource_extraction	Category:Natural_resources	Natural_resource_extraction
Category:Resources	Category:Management	Resource
Category:Restaurants	Category:Gastronomy	Restaurant
Category:Restructuring	Category:Management	Restructuring
Category:Reunions	Category:Society Category:Traditions	Reunions
Category:Revenue_assurance	Category:Sales	Revenue_assurance
Category:Revolution	Category:Society	Revolution
Category:Revolutions	Category:Social_history	Revolution
Category:Rheology	Category:Interdisciplinary_fields	Rheology
Category:Rhetoric	Category:Humanities Category:Linguistics	Rhetoric
Category:Right_of_asylum	Category:Political_philosophy	Right_of_asylum
Category:Rights	Category:Law Category:Politics	Rights
Category:Rights_of_the_accused	Category:Rights	Rights_of_the_accused
Category:Risk_management	Category:Management	Risk_management
Category:Rites_of_passage	Category:Ritual	Rite_of_passage
Category:Ritual	Category:Arts Category:Culture	Ritual
Category:Rituals	Category:Ritual	Ritual
Category:RMIT_University	Category:Technology	RMIT_University
Category:Roast_%28comedy%29	Category:Comedy	Roast_%28comedy%29
Category:Rocket_launch_sites	Category:Geography	List_of_rocket_launch_sites
Category:Rocks	Category:Natural_materials	Rock_%28geology%29
Category:Romanian_society	Category:Society	Culture_of_Romania
Category:Roman_law	Category:Legal_history	Roman_law
Category:Romantic_poets	Category:Arts	Romantic_poetry
Category:Root_vegetables	Category:Crops	List_of_root_vegetables
Category:Ross_Perot	Category:Business	Ross_Perot
Category:Rothschild_family	Category:Business	Rothschild_family
Category:Rowing_clubs	Category:Society	Rowing_club
Category:Rubber	Category:Natural_materials	Natural_rubber
Category:Rules_of_thumb	Category:Traditions	Rule_of_thumb
Category:Running_gags	Category:Comedy	Running_gag
Category:Rural_community_development	Category:Agrarianism	Rural_community_development
Category:Rural_culture	Category:Agrarianism Category:Agriculture Category:Cultures Category:Rural_society	Rural_area
Category:Rural_economics	Category:Rural_society	Rural_economics
Category:Rural_society	Category:Agriculture Category:Society	Rural_sociology
Category:RWTH_Aachen_University	Category:Technology	RWTH_Aachen_University
Category:Sabanc%C4%B1_family	Category:Business	Sabanc%C4%B1_family
Category:Sacred_dance	Category:Arts	Sacred_dance
Category:Sacred_history	Category:Arts	Sacred_history
Category:Safety_equipment	Category:Equipment	Personal_protective_equipment
Category:Sales	Category:Business Category:Marketing	Sales
Category:Salespeople	Category:Sales	Sales
Category:Sales_promotion	Category:Business	Sales_promotion
Category:Sand	Category:Soil	Sand
Category:Sanitation	Category:Hygiene	Sanitation
Category:Sassoon_family	Category:Business	Sassoon_family
Category:Scandinavian_studies	Category:Cultural_anthropology Category:Humanities Category:Interdisciplinary_fields	Scandinavian_studies
Category:Scheduling_%28computing%29	Category:Operations_research	Scheduling_%28computing%29
Category:School_bullying	Category:Education	School_bullying
Category:School_counseling	Category:Educational_psychology Category:Students	School_counselor
Category:Schools	Category:Education	School
Category:Schoolteachers	Category:Teaching	Teacher
Category:Science	\N	Science
Category:Science_and_technology_in_Algeria	Category:Technology	Science_and_technology_in_Algeria
Category:Science_and_technology_in_Argentina	Category:Technology	Science_and_technology_in_Argentina
Category:Science_and_technology_in_Belgium	Category:Technology	Education_in_Belgium
Category:Science_and_technology_in_Brazil	Category:Technology	Brazilian_science_and_technology
Category:Science_and_technology_in_Bulgaria	Category:Technology	Science_and_technology_in_Bulgaria
Category:Science_and_technology_in_China	Category:Technology	History_of_science_and_technology_in_China
Category:Science_and_technology_in_Colombia	Category:Technology	Science_and_technology_in_Colombia
Category:Science_and_technology_in_Germany	Category:Technology	Science_and_technology_in_Germany
Category:Science_and_technology_in_India	Category:Technology	Science_and_technology_in_the_Republic_of_India
Category:Science_and_technology_in_Indonesia	Category:Technology	Science_and_technology_in_Indonesia
Category:Science_and_technology_in_Iran	Category:Technology	Science_and_technology_in_Iran
Category:Science_and_technology_in_Israel	Category:Technology	Science_and_technology_in_Israel
Category:Science_and_technology_in_Italy	Category:Technology	Science_and_technology_in_Italy
Category:Science_and_technology_in_Kazakhstan	Category:Technology	Education_in_Kazakhstan
Category:Science_and_technology_in_Malaysia	Category:Technology	Science_and_technology_in_Malaysia
Category:Science_and_technology_in_Mexico	Category:Technology	History_of_science_and_technology_in_Mexico
Category:Science_and_technology_in_Morocco	Category:Technology	Science_and_technology_in_Morocco
Category:Science_and_technology_in_Pakistan	Category:Technology	Science_and_technology_in_Pakistan
Category:Science_and_technology_in_Portugal	Category:Technology	Science_and_technology_in_Portugal
Category:Science_and_technology_in_Romania	Category:Technology	Science_and_technology_in_Romania
Category:Science_and_technology_in_Russia	Category:Technology	Science_and_technology_in_Russia
Category:Science_and_technology_in_Switzerland	Category:Technology	Science_and_technology_in_Switzerland
Category:Science_and_technology_in_Thailand	Category:Technology	Thailand_National_Science_and_Technology_Development_Agency
Category:Science_and_technology_in_the_Ottoman_Empire	Category:Technology	Science_and_technology_in_the_Ottoman_Empire
Category:Science_and_technology_in_the_People%27s_Republic_of_China	Category:Technology	Science_and_technology_in_the_People%27s_Republic_of_China
Category:Science_and_technology_in_the_Soviet_Union	Category:Technology	Science_and_technology_in_the_Soviet_Union
Category:Science_and_technology_in_the_United_Kingdom	Category:Technology	Science_and_technology_in_the_United_Kingdom
Category:Science_and_technology_in_the_United_States	Category:Technology	Science_and_technology_in_the_United_States
Category:Science_and_technology_in_Venezuela	Category:Technology	Science_and_technology_in_Venezuela
Category:Science_and_technology_studies	Category:Interdisciplinary_fields Category:Science_studies Category:Technology	Science_and_technology_studies
Category:Science_education	Category:Education Category:Science Category:Society	Science_education
Category:Science_experiments	Category:History_of_science Category:Scientific_method	Experiment
Category:Science_festivals	Category:Culture Category:Science Category:Society	Science_festival
Category:Science_fiction	Category:Culture	Science_fiction
Category:Science_in_popular_culture	Category:Culture	Science_in_popular_culture
Category:Science_in_the_Middle_Ages	Category:History_of_science	Science_in_the_Middle_Ages
Category:Science_museums	Category:Culture Category:History_of_science Category:Science Category:Society	Science_museum
Category:Science_parks	Category:Business Category:Technology	Science_park
Category:Science_portal	Category:Science	Portal:Science
Category:Science_studies	Category:Interdisciplinary_fields Category:Science	Science_studies
Category:Science_writing	Category:Science Category:Society	Popular_science
Category:Scientific_classification	Category:Science	Biological_classification
Category:Scientific_controversies	Category:Culture	Scientific_method
Category:Scientific_equipment	Category:Equipment	Scientific_instrument
Category:Scientific_instruments	Category:Science Category:Tools	Scientific_instrument
Category:Scientific_method	Category:Inductive_reasoning Category:Methodology Category:Science Category:Science_studies	Scientific_method
Category:Scientific_modeling	Category:Interdisciplinary_fields Category:Scientific_method	Scientific_modelling
Category:Scientific_revolution	Category:History_of_science Category:Philosophy_of_science	Scientific_revolution
Category:Scientific_skepticism	Category:Culture Category:Science	Scientific_skepticism
Category:Scientific_terminology	Category:Science Category:Terminology	Scientific_terminology
Category:Scientific_theories	Category:Inductive_reasoning Category:Philosophy_of_science Category:Science	Scientific_theory
Category:Scientists	Category:Science	Scientist
Category:Scottish_society	Category:Society	Scottish_national_identity
Category:Scoutcraft	Category:Arts	Scoutcraft
Category:Searches_and_seizures	Category:Law_enforcement	Search_and_seizure
Category:Secret_societies	Category:Society	Secret_society
Category:Secularism	Category:Society	Secularism
Category:Security	Category:Society	Security
Category:Security_studies	Category:Interdisciplinary_fields	Security_studies
Category:Seeds	Category:Agronomy	Seed
Category:Self-care	Category:Health_education	Self_care
Category:Self-defense	Category:Rights	Self-defense
Category:Self-reference	Category:Language	Self-reference
Category:Selling_techniques	Category:Sales	Selling_technique
Category:Semantics	Category:Linguistics Category:Philosophy_of_language	Semantics
Category:Semiconductor_companies	Category:Technology	Semiconductor_sales_leaders_by_year
Category:Semiotics	Category:Interdisciplinary_fields Category:Philosophy_of_language Category:Social_sciences	Semiotics
Category:Separation_of_powers	Category:Government	Separation_of_powers
Category:Sequels	Category:Entertainment	Sequel
Category:Serfdom	Category:Agriculture	Serfdom
Category:Sermons	Category:Rhetoric	Sermon
Category:Service_industries	Category:Marketing	Tertiary_sector_of_the_economy
Category:Settlement_schools	Category:History_of_education	Settlement_school
Category:Sewing	Category:Clothing	Sewing
Category:Sex_and_the_law	Category:Law Category:Society	Sex_and_the_law
Category:Sex_crimes	Category:Society	Sex_and_the_law
Category:Sex_education	Category:Education Category:Health_education Category:Society	Sex_education
Category:Sex_industry	Category:Entertainment Category:Society	Sex_industry
Category:Sexism	Category:Society	Sexism
Category:Sexologists	Category:Scientists	Sexology
Category:Sex_toys	Category:Equipment	Sex_toy
Category:Sexual_abuse	Category:Society	Sexual_abuse
Category:Sexual_fidelity	Category:Society	Fidelity
Category:Sexual_harassment	Category:Society	Sexual_harassment
Category:Sexual_health	Category:Health	Reproductive_health
Category:Sexuality_and_religion	Category:Society	Religion_and_sexuality
Category:Sexuality_in_Japan	Category:Society	Sexuality_in_Japan
Category:Sexualization	Category:Society	Sexualization
Category:Sexual_revolution	Category:Social_change Category:Society	Sexual_revolution
Category:Shakespearean_tragedies	Category:Tragedy	Shakespearean_tragedy
Category:Shelburne_Museum	Category:Museology	Shelburne_Museum
Category:Ships_preserved_in_museums	Category:Historic_preservation	Ships_preserved_in_museums
Category:Shoemaking	Category:Arts	Shoemaking
Category:Sign_languages	Category:Languages	List_of_sign_languages
Category:Sign_systems	Category:Communication	Sign_system
Category:Silicon_Valley	Category:Business Category:Technology	Silicon_Valley
Category:Simple_machines	Category:Tools	Simple_machine
Category:Simulation	Category:Operations_research	Simulation
Category:Sindhology	Category:Area_studies	Sindhology
Category:Singularitarianism	Category:Technology	Singularitarianism
Category:Sinology	Category:Area_studies Category:Cultural_anthropology	Sinology
Category:Skepticism	Category:Philosophy_of_science	Skepticism
Category:Skills	Category:Learning	Skill
Category:Skin_care	Category:Hygiene	Cosmetics
Category:Slashdot	Category:Technology	Slashdot
Category:Slavic_history	Category:History	Slavic_peoples
Category:Slavistics	Category:Area_studies	Slavic_studies
Category:Sleep	Category:Health	Sleep
Category:Slogans	Category:Creative_works	Slogan
Category:Small_business	Category:Business	Small_business
Category:Small_Business_Administration	Category:Small_business	Small_Business_Administration
Category:Smock_mills	Category:Agriculture	Smock_mill
Category:Smuggling	Category:Commerce	Smuggling
Category:Snap_elections	Category:Elections	Snap_election
Category:Social_change	Category:Society Category:Sociology	Social_change
Category:Social_constructionism	Category:Politics	Social_constructionism
Category:Social_democracy	Category:Political_philosophy	Social_democracy
Category:Social_entrepreneurship	Category:Society	Social_entrepreneurship
Category:Social_epistemology	Category:Philosophy_of_science Category:Science_and_technology_studies	Social_epistemology
Category:Social_finance	Category:Finance	Social_finance
Category:Social_geography	Category:Human_geography	Social_geography
Category:Social_groups	Category:Corporate_groups	Social_group
Category:Social_guidance_films	Category:Education	Social_guidance_film
Category:Social_history	Category:History Category:Society	Social_history
Category:Social_inclusion	Category:Political_philosophy	Social_exclusion
Category:Social_inequality	Category:Politics Category:Society	Social_inequality
Category:Social_institutions	Category:Corporate_groups Category:Culture Category:Society	Institution
Category:Socialism	Category:Culture Category:Political_philosophy Category:Politics	Socialism
Category:Socialization	Category:Politics	Socialization
Category:Social_media	Category:Society	Social_media
Category:Social_movements	Category:Culture Category:Social_change	Social_movement
Category:Social_networks	Category:Communication	Social_network
Category:Social_policy	Category:Society	Social_policy
Category:Social_psychology	Category:Social_sciences	Social_psychology
Category:Social_responsibility	Category:Business_ethics Category:Society	Social_responsibility
Category:Social_sciences	Category:Science Category:Society	Social_sciences
Category:Social_scientists	Category:Scientists Category:Social_sciences	Social_sciences
Category:Social_software	Category:Social_media	Social_software
Category:Social_statistics	Category:Social_sciences	Social_statistics
Category:Social_systems	Category:Sociology Category:Systems	Social_system
Category:Social_work	Category:Health_sciences Category:Society	Social_work
Category:Social_workers	Category:Social_work	Social_work
Category:Society	\N	Society
Category:Society_for_Science_and_the_Public	Category:Education	Society_for_Science_and_the_Public
Category:Society_for_Worldwide_Interbank_Financial_Telecommunication	Category:Technical_communication	Society_for_Worldwide_Interbank_Financial_Telecommunication
Category:Society_of_the_People%27s_Republic_of_China	Category:Society	Society_of_the_People%27s_Republic_of_China
Category:Sociocultural_evolution	Category:Cultural_history Category:Evolution	Sociocultural_evolution
Category:Socioeconomics	Category:Society	Socioeconomics
Category:Sociolinguistics	Category:Linguistics	Sociolinguistics
Category:Sociological_terms	Category:Sociology Category:Terminology	Sociology
Category:Sociologists	Category:Sociology	Sociology
Category:Sociology	Category:Interdisciplinary_fields Category:Social_sciences Category:Society	Sociology
Category:Sociology_of_culture	Category:Culture Category:Sociology	Sociology_of_culture
Category:Sociology_of_education	Category:Education_theory	Sociology_of_education
Category:Sociology_of_law	Category:Law	Sociology_of_law
Category:Sociology_of_religion	Category:Religion Category:Society	Sociology_of_religion
Category:Sociology_of_science	Category:Science	Sociology_of_scientific_knowledge
Category:Sociology_of_scientific_knowledge	Category:Philosophy_of_science Category:Science_studies Category:Sociology_of_science	Sociology_of_scientific_knowledge
Category:Soft_matter	Category:Matter	Soft_matter
Category:Software_distribution	Category:Business_models	Software_distribution
Category:Soil	Category:Agriculture Category:Natural_materials Category:Natural_resources	Soil
Category:Soil_contamination	Category:Soil	Soil_contamination
Category:Soil_mechanics	Category:Soil	Soil_mechanics
Category:Soil_science	Category:Soil	Soil_science
Category:Solids	Category:Matter	Solid
Category:Sound_technology	Category:Technology	Sound_recording_and_reproduction
Category:South_Korean_society	Category:Society	Culture_of_South_Korea
Category:Sovereign_immunity	Category:Common_law	Sovereign_immunity
Category:Soviet_society	Category:Society	Culture_of_the_Soviet_Union
Category:Space_elevator	Category:Technology	Space_elevator
Category:Space_law	Category:Law	Space_law
Category:Space_technology	Category:Technology	Space_technology
Category:Spanish_society	Category:Society	Spain
Category:Special_Economic_Zones	Category:Globalization	Special_Economic_Zone
Category:Special_education	Category:Alternative_education Category:Disability Category:Education Category:Educational_psychology Category:Philosophy_of_education	Special_education
Category:Speech	Category:Language	Speech
Category:Speech_and_language_pathology	Category:Language Category:Speech	Speech_and_language_pathology
Category:Speeches	Category:Rhetoric	Public_speaking
Category:Speech_processing	Category:Language Category:Speech	Speech_processing
Category:Speech_recognition	Category:Speech	Speech_recognition
Category:Speech_synthesis	Category:Language	Speech_synthesis
Category:Spelling	Category:Language Category:Writing	Spelling
Category:Spelling_reform	Category:Language_policy	Spelling_reform
Category:Sport_and_politics	Category:Politics	Politics_and_sports
Category:Sports	Category:Entertainment	Sport
Category:Sports_business	Category:Business	Sport_management
Category:Sports_clubs	Category:Society	Sports_club
Category:Sports_entertainment	Category:Entertainment	Sports_entertainment
Category:Sports_law	Category:Health_law Category:Law	Sports_law
Category:Sprachbund	Category:Languages	Sprachbund
Category:Stagecraft	Category:Arts	Stagecraft
Category:Standardized_tests	Category:Education	Standardized_test
Category:Standards-based_education	Category:Education	Outcome-based_education
Category:Stand-up_comedy	Category:Comedy	Stand-up_comedy
Category:Statistical_theory	Category:Scientific_theories	Statistical_theory
Category:Statutory_law	Category:Law	Statutory_law
Category:Stellar_evolution	Category:Evolution	Stellar_evolution
Category:Steve_Jobs	Category:Business	Steve_Jobs
Category:Steven_Spielberg	Category:Business	Steven_Spielberg
Category:Stock_characters	Category:Drama	Stock_character
Category:Stock_market	Category:Commerce	Stock_market
Category:Storytelling	Category:Performing_arts	Storytelling
Category:Strategic_management	Category:Management	Strategic_management
Category:Structuralism	Category:Linguistics	Structuralism
Category:Structure	Category:Matter	Structure
Category:Structure_of_the_Earth	Category:Earth	Structure_of_the_Earth
Category:Student_exchange	Category:Culture Category:Education Category:Students	Student_exchange_program
Category:Student_financial_aid	Category:Education Category:Students	Student_financial_aid_in_the_United_States
Category:Student_government	Category:Government	Students%27_union
Category:Student_organizations	Category:Education Category:Society Category:Students	Student_society
Category:Students	Category:Education	Student
Category:Students%27_unions	Category:Education	Students%27_union
Category:Study_of_religion	Category:Humanities Category:Interdisciplinary_fields Category:Religion Category:Social_sciences	Religious_studies
Category:Subatomic_particles	Category:Matter	Subatomic_particle
Category:Subcultures	Category:Cultures	Subculture
Category:Sufi_literature	Category:Arts	Sufi_poetry
Category:Suicide	Category:Sociology	Suicide
Category:Summer_camps	Category:Alternative_education	Summer_camp
Category:Supertasks	Category:Logic	Supertask
Category:Supply_chain_management	Category:Management	Supply_chain_management
Category:Surgical_instruments	Category:Tools	Surgical_instrument
Category:Surveying	Category:Geography	Surveying
Category:Sustainable_agriculture	Category:Agriculture	Sustainable_agriculture
Category:Sustainable_development	Category:Economics	Sustainable_development
Category:Sustainable_energy	Category:Energy	Sustainable_energy
Category:Sustainable_gardening	Category:Agriculture Category:Landscape	Sustainable_gardening
Category:Symmetry	Category:Aesthetics	Symmetry
Category:Symptoms	Category:Health	Symptom
Category:Syndromes	Category:Health	Syndrome
Category:Syntax	Category:Linguistics Category:Philosophy_of_language	Syntax
Category:Systems	Category:Nature	System
Category:Systems_biology	Category:Interdisciplinary_fields	Systems_biology
Category:Systems_science	Category:Interdisciplinary_fields Category:Systems	Systems_science
Category:Systems_scientists	Category:Scientists	Systems_science
Category:Systems_theory	Category:Interdisciplinary_fields Category:Philosophy_of_science Category:Systems	Systems_theory
Category:Taxation	Category:Accountancy	Tax
Category:Tax_software	Category:Business_software	Tax_compliance_software
Category:Teacher_training	Category:Education Category:Teaching Category:Training	Teacher_education
Category:Teaching	Category:Communication Category:Education Category:Learning	Education
Category:Tea_Party_movement	Category:Political_activism	Tea_Party_movement
Category:Technical_communication	Category:Communication Category:Technology	Technical_communication
Category:Technical_communication_tools	Category:Technical_communication	Technical_communication_tools
Category:Technical_terminology	Category:Terminology	Technical_terminology
Category:Technical_University_of_Denmark	Category:Technology	Technical_University_of_Denmark
Category:Technicians	Category:Technology	Technician
Category:Technological_change	Category:Technology	Technological_change
Category:Technologists	Category:Scientists	Engineering_technologist
Category:Technology	Category:Science	Technology
Category:Technology_portal	Category:Technology	Portal:Technology
Category:Technology_strategy	Category:Technology	Technology_strategy
Category:Technology_systems	Category:Technology	Technology
Category:Technology_transfer	Category:Technology	Technology_transfer
Category:TED_Conference	Category:Technology	TED_%28conference%29
Category:Telecommunications	Category:Communication Category:Technology	Telecommunication
Category:Telecommunications_systems	Category:Technology_systems	Telecommunication
Category:Telecommuting	Category:Business	Telecommuting
Category:Telehealth	Category:Health_informatics Category:Society Category:Technology	Telehealth
Category:Telemarketing	Category:Business	Telemarketing
Category:Telepresence	Category:Society Category:Technology	Telepresence
Category:Television	Category:Entertainment Category:Wireless	Television
Category:Television_commercials	Category:Business	Television_advertisement
Category:Television_drama	Category:Drama	Dramatic_programming
Category:Television_studies	Category:Media_studies	Television_studies
Category:Ten_Commandments	Category:Legal_history	Ten_Commandments
Category:Terminologists	Category:Terminology	Terminology
Category:Terminology	Category:Language	Terminology
Category:Terrorism	Category:Politics	Terrorism
Category:Texas_Tech_University	Category:Technology	Texas_Tech_University
Category:Textbooks	Category:Education	Textbook
Category:Textile_arts	Category:Arts	Textile_arts
Category:Textiles	Category:Clothing	Textile
Category:Textual_criticism	Category:Philology	Textual_criticism
Category:Theatre	Category:Entertainment Category:Performing_arts	Theatre
Category:Theatre_portal	Category:Arts	Portal:Theatre
Category:Theatres	Category:Arts	Theatre
Category:Theatrical_combat	Category:Performing_arts	Stage_combat
Category:Theocracies	Category:Society	Theocracy
Category:Theoretical_physics	Category:Scientific_theories	Theoretical_physics
Category:Theories_of_gravitation	Category:Scientific_theories	Gravitation
Category:Theory_of_Constraints	Category:Management	Theory_of_Constraints
Category:Therapeutics	Category:Health_policy	Therapy
Category:Therapy	Category:Healthcare	Therapy
Category:Thermodynamic_processes	Category:Phenomena	Thermodynamic_process
Category:Third_gender	Category:Gender_studies	Third_gender
Category:Time%E2%80%93frequency_analysis	Category:Computational_science	Time%E2%80%93frequency_analysis
Category:Time_management	Category:Business Category:Life_skills Category:Management	Time_management
Category:Time_zones	Category:Human_geography	Time_zone
Category:Tobacco	Category:Crops	Tobacco
Category:Tobacco_control	Category:Health_policy	Tobacco_control
Category:Toilet_paper	Category:Hygiene	Toilet_paper
Category:Toll_roads	Category:Pricing	Toll_road
Category:Tonal_languages	Category:Languages	Tone_%28linguistics%29
Category:Tools	Category:Equipment Category:Technology	Tool
Category:Topography	Category:Geography	Topography
Category:Toponymy	Category:Geography	Toponymy
Category:Tort_law	Category:Common_law	Tort
Category:Torture	Category:Philosophy_of_law	Torture
Category:Tour_guides	Category:Culture	Tour_guide
Category:Tourism	Category:Entertainment	Tourism
Category:Tourism_geography	Category:Human_geography	Tourism_geography
Category:Toyota	Category:Business	Toyota
Category:Toys	Category:Creative_works Category:Entertainment	Toy
Category:Trade	Category:Business Category:Commerce	Trade
Category:Trade_associations	Category:Business_organizations	Trade_association
Category:Trade_policy	Category:Trade	Commercial_policy
Category:Trade_routes	Category:Trade	Trade_route
Category:Trade_secrets	Category:Trade	Trade_secret
Category:Trade_shows	Category:Trade	Trade_fair
Category:Trading_posts	Category:Commerce Category:Trade	Trading_post
Category:Traditional_games	Category:Traditions	Traditional_game
Category:Traditional_medicine	Category:Medicine Category:Traditions	Traditional_medicine
Category:Traditional_music	Category:Traditions	Traditional_music
Category:Traditional_stories	Category:Traditions	Traditional_stories
Category:Traditions	Category:Cultural_anthropology Category:Culture	Tradition
Category:Trag%C3%A9dies_en_musique	Category:Tragedy	Trag%C3%A9die_en_musique
Category:Tragedy	Category:Drama Category:Entertainment Category:Humanities Category:Performing_arts	Tragedy
Category:Training	Category:Education	Training
Category:Transdisciplinarity	Category:Interdisciplinary_fields	Transdisciplinarity
Category:Translation	Category:Linguistics	Translation
Category:Translation_dictionaries	Category:Language_acquisition	Bilingual_dictionary
Category:Translation_software	Category:Language_software	Machine_translation
Category:Translators	Category:Literature	Translation
Category:Transliteration	Category:Linguistics	Transliteration
Category:Transmetals	Category:Fictional_technology	Transmetals
Category:Transnationalism	Category:Globalization	Transnationalism
Category:Transpersonal_studies	Category:Interdisciplinary_fields	Transpersonal
Category:Transport	Category:Technology	Transport
Category:Transport_law	Category:Law	Transport_law
Category:Travel_books	Category:Geography	Travel_literature
Category:Travelling_salesman_problem	Category:Operations_research	Travelling_salesman_problem
Category:Travel_technology	Category:Technology	Travel_technology
Category:Treasure	Category:Archaeology	Treasure
Category:Treaty_of_Waitangi	Category:Law	Treaty_of_Waitangi
Category:Tree_of_life	Category:Scientific_classification	Tree_of_life
Category:Tribal_chiefs	Category:Politics	Tribal_chief
Category:Trivia	Category:Entertainment	Trivia
Category:TRIZ	Category:Scientific_theories	TRIZ
Category:Tropical_agriculture	Category:Agriculture	Tropical_agriculture
Category:True_crime	Category:Crime	True_crime
Category:Truman_Scholars	Category:Education	Harry_S._Truman_Scholarship
Category:Tsim_Sha_Tsui	Category:Business	Tsim_Sha_Tsui
Category:Turkology	Category:Cultural_anthropology	Turkology
Category:Twirling	Category:Performing_arts	Twirling
Category:Types_of_business_entity	Category:Companies	Types_of_business_entity
Category:Types_of_cancer	Category:Health	List_of_cancer_types
Category:Typing	Category:Business	Typing
Category:Ukrainian_society	Category:Society	Ukrainians
Category:Unclassified_languages	Category:Languages	Unclassified_language
Category:Undescribed_species	Category:Scientific_classification	Undescribed_taxon
Category:Unemployment	Category:Society	Unemployment
Category:UNESCO	Category:Education	UNESCO
Category:Unified_Modeling_Language	Category:Technical_communication	Unified_Modeling_Language
Category:Uniform_Acts	Category:Statutory_law	Uniform_Act
Category:Uniform_Commercial_Code	Category:Business_law	Uniform_Commercial_Code
Category:Universe	Category:Nature Category:Reality	Universe
Category:University_and_college_admissions	Category:Education_policy	University_and_college_admissions
Category:UN/LOCODE	Category:Geocodes	UN/LOCODE
Category:Unsolved_problems_in_linguistics	Category:Linguistics	List_of_unsolved_problems_in_linguistics
Category:Urban_agriculture	Category:Agriculture	Urban_agriculture
Category:Urban_animals	Category:Culture	Urban_wildlife
Category:Urban_exploration	Category:Exploration	Urban_exploration
Category:Urban_geography	Category:Human_geography	Urban_geography
Category:Urban_studies_and_planning	Category:Interdisciplinary_fields Category:Social_sciences	Urban_planning
Category:USA_PATRIOT_Act	Category:Law	USA_PATRIOT_Act
Category:Vacuum	Category:Matter	Vacuum
Category:Validity_%28statistics%29	Category:Philosophy_of_science	Validity_%28statistics%29
Category:Variety_entertainment	Category:Entertainment Category:Performing_arts	Variety_show
Category:Vegetables	Category:Crops	Vegetable
Category:Vergangenheitsbew%C3%A4ltigung	Category:Historiography	Vergangenheitsbew%C3%A4ltigung
Category:Vernacular_geography	Category:Geography	Vernacular_geography
Category:Veterinarians	Category:Health	Veterinarian
Category:Veterinary_drugs	Category:Veterinary_medicine	List_of_veterinary_drugs
Category:Veterinary_medicine	Category:Agriculture Category:Health_sciences Category:Medicine	Veterinary_medicine
Category:Veterinary_parasitology	Category:Veterinary_medicine	Veterinary_parasitology
Category:Veto	Category:Government	Veto
Category:Vienna_Circle	Category:Philosophy_of_science	Vienna_Circle
Category:Vigilantes	Category:Law_enforcement	Vigilante
Category:Violence_against_women	Category:Gender_studies	Violence_against_women
Category:Viral_marketing	Category:Business	Viral_marketing
Category:Virtual_communities	Category:Society	Virtual_community
Category:Virtual_reality	Category:Reality	Virtual_reality
Category:Visitor_attractions	Category:Entertainment Category:Geography Category:Human_geography	Tourist_attraction
Category:Visual_anthropology	Category:Cultural_anthropology	Visual_anthropology
Category:Visual_arts	Category:Arts	Visual_arts
Category:Visual_thinking	Category:Educational_psychology	Visual_thinking
Category:Vitalism	Category:Philosophy_of_science	Vitalism
Category:Viticulture	Category:Agriculture	Viticulture
Category:Vocabulary	Category:Language Category:Terminology	Vocabulary
Category:Vocational_education	Category:Education	Vocational_education
Category:Voting_theory	Category:Politics	Voting_system
Category:Walt_Disney	Category:Business	Walt_Disney
Category:War	Category:Society	War
Category:Warburg_family	Category:Business	Warburg_family
Category:Warez	Category:Law	Warez
Category:Waste_management	Category:Management	Waste_management
Category:Water	Category:Health Category:Natural_resources	Water
Category:Water_security	Category:Society	Water_security
Category:Water_wells	Category:Agriculture	Water_well
Category:Wealth	Category:Socioeconomics	Wealth
Category:Weapons	Category:Tools	Weapon
Category:Weather_lore	Category:Science	Weather_lore
Category:Wedding_traditions	Category:Traditions	Wedding
Category:Weight_loss	Category:Health	Weight_loss
Category:Welfare_economics	Category:Socioeconomics	Welfare_economics
Category:Whistleblowing	Category:Crime Category:Government	Whistleblower
Category:Windows	Category:Home	Microsoft_Windows
Category:Wine_regions	Category:Agriculture	List_of_wine-producing_regions
Category:Wineries	Category:Agriculture	Winery
Category:Wireless	Category:Technology	Wireless
Category:Wireless_networking	Category:Mobile_technology Category:Wireless	Wireless_network
Category:Wisdom_literature	Category:Arts Category:Education Category:Literature	Wisdom_literature
Category:Witch_hunting	Category:Legal_history	Witch-hunt
Category:Womanist_theology	Category:Society	Womanist_theology
Category:Women%27s_health	Category:Health	Women%27s_health
Category:Women%27s_rights	Category:Human_rights	Women%27s_rights
Category:Women_artists	Category:Arts	Women_artists
Category:Women_in_business	Category:Businesspeople	Women_in_business
Category:Woodcarving	Category:Arts	Wood_carving
Category:Worcester_Polytechnic_Institute	Category:Technology	Worcester_Polytechnic_Institute
Category:Word_coinage	Category:Vocabulary	Neologism
Category:Word_games	Category:Linguistics	Word_game
Category:Word_play	Category:Linguistics	Word_play
Category:Workflow_technology	Category:Business_software	Workflow_technology
Category:Working_animals	Category:Culture	Working_animal
Category:Working_conditions	Category:Industrial_relations	Occupational_safety_and_health
Category:Works_of_art	Category:Visual_arts	Work_of_art
Category:World	Category:Earth Category:Geography	World
Category:World_government	Category:Globalization Category:Global_politics Category:Political_philosophy	World_government
Category:Wormholes_in_fiction	Category:Fictional_technology	Wormholes_in_fiction
Category:Writing	Category:Language	Writing
Category:Writing_instruments	Category:Tools Category:Writing	Writing_implement
Category:Written_communication	Category:Communication Category:Writing	Writing
Category:Years	Category:Chronology	Year
Category:Youth_work	Category:Social_work	Youth_work
Category:Zoonoses	Category:Culture	Zoonosis
